Name,Volume,Ask Size,Ask Price,Bid Size,Bid Price,Last Price,Shares Matched,Shares Routed
F,10927782,2400,11.5400,12102,11.5300,11.5400,10694975,232807
CTRM,9077529,600,0.3980,600,0.3958,0.3962,8801120,276409
UVXY,6208024,25300,10.1100,10895,10.1000,10.1000,5955445,252579
NAKD,5653737,700,0.4645,1000,0.4640,0.4649,4995389,658348
AAPL,5620672,200,136.9800,300,136.9700,136.9700,5336944,283728
ACST,5026800,100,0.8400,1300,0.8309,0.8300,4517804,508996
CLSN,5000463,1700,1.6800,1900,1.6700,1.6750,4402140,598323
BBIG,4173140,300,5.0000,100,4.9500,4.9800,3700213,472927
VXX,3779490,22730,16.2800,472,16.2700,16.2700,3729881,49609
QTT,3417717,500,4.6500,100,4.6400,4.6600,3335377,82340
ZNGA,2956332,6850,10.4000,1700,10.3900,10.3950,2840056,116276
SPY,2712289,349,384.7700,1136,384.7500,384.7600,2556752,155537
SENS,2671732,500,2.4100,45581,2.4000,2.4050,2526117,145615
IWM,2651439,106,213.3200,1900,213.3100,213.3300,2601198,50241
INTC,2388172,400,60.9500,759,60.9400,60.9400,2338301,49871
EWZ,2382757,4600,35.8800,6480,35.8700,35.8800,2302503,80254
CIDM,2341257,1900,1.3700,2900,1.3600,1.3700,2159381,181876
XLF,2329139,65308,30.6800,56150,30.6700,30.6800,2257440,71699
ADTX,2270125,100,4.0200,100,4.0100,4.0100,2096372,173753
BIOL,2246962,10260,1.0800,16251,1.0700,1.0700,2204397,42565
AMD,2195153,400,91.7000,600,91.6700,91.6800,2138464,56689
AZRX,2169630,1000,1.2800,300,1.2700,1.2800,2129996,39634
SNDL,2141094,100,0.6606,100,0.6602,0.6607,2037615,103479
GSAT,2100305,2800,1.2400,28894,1.2300,1.2400,2015895,84410
BAC,2079514,2877,31.9100,7975,31.9000,31.9000,2029498,50016
XLE,2042696,1966,42.4200,8000,42.4100,42.4200,1988581,54115
TRXC,2028940,1120,3.2400,100,3.2300,3.2400,1984524,44416
BB,2010668,704,12.8300,500,12.8200,12.8200,1942209,68459
GM,1906846,195,54.9200,200,54.9100,54.9200,1824859,81987
TQQQ,1858444,300,101.7500,1500,101.7300,101.7300,1833568,24876
SQQQ,1796674,20250,13.2600,27355,13.2500,13.2600,1703783,92891
ITUB,1764748,14215,5.5900,38400,5.5800,5.5900,1753559,11189
APHA,1668072,4550,12.8000,623,12.7900,12.7950,1637467,30605
DVN,1666342,500,18.3600,1397,18.3500,18.3600,1635230,31112
VALE,1665240,12000,17.3700,3400,17.3600,17.3700,1621427,43813
GEVO,1607917,300,9.1300,300,9.1200,9.1200,1532445,75472
QQQ,1590726,2080,326.7200,800,326.7000,326.7000,1536588,54138
ATOS,1578088,981,1.6900,700,1.6800,1.6850,1519579,58509
GE,1562315,14100,11.1200,8974,11.1100,11.1100,1528860,33455
GME,1496199,100,42.1900,300,42.0500,42.0500,1457041,39158
PLUG,1466636,50,64.6000,105,64.5200,64.5700,1386732,79904
INUV,1441405,9581,1.7300,11850,1.7200,1.7300,1394723,46682
ARKG,1415551,185,109.5100,201,109.4800,109.4800,1399574,15977
BNGO,1412488,800,8.3400,1100,8.3300,8.3350,1303210,109278
NIO,1410116,205,58.4000,900,58.3600,58.3800,1341168,68948
DD,1402715,400,81.3400,200,81.3000,81.3200,1398323,4392
AAL,1402064,3466,15.8500,3001,15.8400,15.8400,1361842,40222
EEM,1364526,13100,56.3800,16010,56.3700,56.3700,1293904,70622
MRO,1351648,7900,8.2800,6200,8.2700,8.2800,1336548,15100
SLV,1333809,26700,24.1200,23900,24.1100,24.1200,1303176,30633
NNDM,1325954,2000,12.6400,200,12.6200,12.6300,1268404,57550
MSFT,1323249,92,225.9500,800,225.9200,225.9300,1272601,50648
BBD,1291887,44852,4.7600,71420,4.7500,4.7550,1284341,7546
UAL,1234991,500,42.7800,100,42.7700,42.7700,1218462,16529
GENE,1211362,50,5.6400,200,5.5600,5.6000,1093949,117413
FCEL,1203705,100,17.4500,100,17.4000,17.4600,1178366,25339
GDX,1194483,3375,35.6100,2975,35.6000,35.6100,1155655,38828
BK,1091716,300,42.4800,300,42.4600,42.4800,1074358,17358
PFE,1077217,2100,36.4400,3082,36.4300,36.4350,1047664,29553
ITRM,1040089,1050,1.8900,6062,1.8800,1.8850,993763,46326
SIRI,1032429,34750,6.0300,17324,6.0200,6.0250,1007296,25133
PTN,1030343,4374,1.1600,8232,1.1500,1.1550,858728,171615
OPTT,1027329,500,4.3300,1400,4.3100,4.3050,990719,36610
ABEV,1025676,68775,2.9500,40527,2.9400,2.9450,1025628,48
FB,960953,79,273.1400,100,273.0900,273.1400,942560,18393
ADMP,956882,2025,1.2600,8840,1.2500,1.2550,890868,66014
XLB,941793,2550,74.9200,1800,74.9100,74.9100,902052,39741
XOM,931553,421,48.2300,748,48.2200,48.2300,899374,32179
INO,930709,624,9.0700,1200,9.0600,9.0700,876785,53924
PBR,925928,11931,10.5000,7850,10.4900,10.5000,881761,44167
MARA,922969,700,18.3600,700,18.3100,18.3800,895756,27213
EFA,912076,7400,75.3900,19226,75.3800,75.3850,879466,32610
HYG,911958,10000,87.5100,11729,87.5000,87.5050,791630,120328
AZN,909744,220,52.5000,1000,52.4900,52.4900,874581,35163
TZA,907664,45876,5.2300,32900,5.2200,5.2300,855364,52300
MS,905381,484,75.0000,300,74.9800,74.9700,856119,49262
CSCO,902064,810,45.1700,2313,45.1600,45.1650,879658,22406
BLDP,892919,200,35.8600,200,35.8300,35.8500,873566,19353
UXIN,887346,25700,1.3300,6600,1.3200,1.3250,837015,50331
AMC,883060,3800,2.9800,6865,2.9700,2.9750,797566,85494
XLI,874303,4100,89.1900,3500,89.1700,89.1800,858833,15470
ITB,867464,350,61.5600,1125,61.5500,61.5600,851515,15949
COP,852771,109,43.4000,320,43.3800,43.3900,799448,53323
LAC,847349,100,23.0000,500,22.9800,23.0000,821091,26258
PLTR,841879,956,26.0500,200,26.0300,26.0400,821058,20821
ZOM,839273,207904,1.0100,255139,1.0000,1.0000,747291,91982
C,837385,100,62.0400,500,62.0300,62.0400,801433,35952
CCL,835450,1123,20.7900,2295,20.7800,20.7800,812776,22674
RIOT,834602,1,19.8200,400,19.6900,19.7500,821596,13006
FUBO,831586,205,34.4000,1,34.2700,34.3800,790050,41536
IEMG,830436,5200,67.4700,11300,67.4600,67.4650,811750,18686
POAI,820133,1100,1.2800,300,1.2600,1.2700,780056,40077
XLU,797022,2600,62.9900,2300,62.9800,62.9800,776883,20139
GOLD,794935,3500,23.6500,8300,23.6400,23.6400,779821,15114
WFC,778943,1102,32.1500,2300,32.1400,32.1400,747461,31482
SOLO,769306,400,8.3700,14,8.3600,8.3700,729159,40147
CRBP,761050,416,2.2500,100,2.2400,2.2500,734973,26077
NOK,758164,51821,4.2200,53272,4.2100,4.2200,754772,3392
VZ,757939,1103,57.3200,1300,57.3100,57.3150,730546,27393
LQD,753303,3700,135.8800,496,135.8700,135.8700,680954,72349
TSLA,742958,10,846.9400,1,846.7100,846.8500,647469,95489
UBER,733170,300,56.1000,402,56.0900,56.1000,723446,9724
BMY,732940,400,64.4600,400,64.4500,64.4700,712154,20786
CMCSA,731112,300,49.0800,600,49.0700,49.0700,707279,23833
FXI,728577,5036,52.0000,2904,51.9900,51.9950,697030,31547
WPRT,727440,200,8.5700,100,8.5400,8.5700,700745,26695
XOP,724395,600,67.8600,500,67.8400,67.8500,673732,50663
SNAP,723513,12,54.3400,100,54.3200,54.3400,681282,42231
KGC,716609,48450,7.1100,3900,7.1000,7.1000,676330,40279
JAGX,714030,2600,3.0800,500,3.0700,3.0700,589966,124064
SLB,713428,400,24.3200,400,24.3100,24.3200,672232,41196
WORK,707648,700,42.4200,1300,42.4100,42.4100,690281,17367
TLT,702465,1200,151.2700,1500,151.2500,151.2600,673443,29022
KRE,698162,1050,57.5400,900,57.5300,57.5200,678176,19986
NOVN,698117,2750,1.3700,2200,1.3600,1.3700,651293,46824
KO,697260,400,48.9100,3448,48.9000,48.9100,676137,21123
RIG,687558,3200,2.7000,16900,2.6900,2.7000,615604,71954
MRNA,687229,163,133.8100,100,133.5300,133.7100,669888,17341
IVR,677815,7892,3.5800,7700,3.5700,3.5750,646694,31121
AUY,676828,48681,5.2200,39100,5.2100,5.2150,667907,8921
HAL,667605,1798,19.4500,700,19.4300,19.4400,635129,32476
BABA,665339,150,260.0000,200,259.9000,259.9300,647739,17600
USB,661658,105,45.9800,700,45.9700,45.9800,609665,51993
XLV,659571,100,118.0800,1250,118.0700,118.0700,634203,25368
BBBY,651683,200,27.6400,300,27.5800,27.5800,618853,32830
BKR,644787,300,22.6500,104,22.6400,22.6600,641918,2869
ARKK,643398,100,145.0500,100,145.0200,145.0200,615775,27623
AR,640026,1900,6.5800,1600,6.5700,6.5700,632321,7705
SWN,636513,11289,3.4200,4842,3.4100,3.4150,620503,16010
TNXP,628674,500,0.9820,500,0.9779,0.9801,618086,10588
BP,626048,3297,24.0200,2225,24.0100,24.0150,616591,9457
T,620744,4100,28.8900,1100,28.8800,28.8900,607726,13018
FCX,620183,1654,30.0900,1000,30.0700,30.0800,600060,20123
TAL,619320,200,78.6500,120,78.4600,78.5600,601004,18316
CVE,607569,15536,6.1500,24200,6.1400,6.1500,605141,2428
OXY,604813,490,21.7600,611,21.7500,21.7600,581293,23520
IDEX,602829,5000,3.1800,300,3.1700,3.1700,595131,7698
ABNB,602812,107,183.0000,100,182.6300,182.7400,591069,11743
ITP,600193,56,0.8616,300,0.8500,0.8616,538291,61902
GFI,595825,2000,9.5900,2100,9.5800,9.5900,580642,15183
X,592744,100,19.3900,600,19.3700,19.3700,560961,31783
ET,586825,3585,6.7200,6990,6.7100,6.7150,578518,8307
TSM,586047,200,133.8800,40,133.8500,133.8700,564673,21374
KMI,574391,1300,15.3300,400,15.3200,15.3200,568215,6176
APA,572407,1017,16.7400,1201,16.7200,16.7250,542943,29464
AEO,562458,400,24.0300,700,24.0100,24.0100,548091,14367
OGEN,559622,3663,1.0200,25999,1.0100,1.0200,536527,23095
FLEX,557875,500,19.4200,400,19.4100,19.4000,548541,9334
SCHW,557300,200,58.7900,612,58.7800,58.7900,539514,17786
AG,555740,1600,13.5800,350,13.5700,13.5750,534074,21666
VIAC,554933,300,45.0000,200,44.9700,44.9800,541106,13827
MU,553704,7,84.0700,200,84.0500,84.0500,523783,29921
TELL,545364,3107,2.6500,200,2.6400,2.6450,540056,5308
HBAN,544916,2752,14.5600,2100,14.5500,14.5600,535134,9782
VWO,541938,7300,54.3900,6600,54.3800,54.3900,500940,40998
DAL,534031,103,40.7500,800,40.7400,40.7500,514896,19135
NLY,533364,19600,8.4300,31409,8.4200,8.4250,521901,11463
SU,532583,500,18.1700,6875,18.1600,18.1600,523858,8725
BTG,530794,16600,5.1500,41200,5.1400,5.1450,518887,11907
ACB,530363,400,11.1900,1300,11.1800,11.1900,511596,18767
UMC,529994,756,10.0300,2668,10.0200,10.0250,499569,30425
ASRT,526425,500,0.7743,700,0.7600,0.7720,520524,5901
JPM,524535,107,135.1900,500,135.1600,135.1600,512228,12307
XLP,523113,1400,65.2900,9700,65.2800,65.2800,474970,48143
XLK,522857,1550,133.3600,101,133.3500,133.3500,512725,10132
ADXS,521793,100,0.7700,1400,0.7650,0.7680,437830,83963
KIM,515985,755,16.6100,939,16.6000,16.6050,500886,15099
MUR,515695,200,13.0000,200,12.9900,12.9900,486342,29353
PG,515004,200,131.2800,100,131.2600,131.2600,488820,26184
IAU,511233,117350,17.8100,120498,17.8000,17.8050,507533,3700
IYR,510740,175,85.8000,2800,85.7900,85.7900,500856,9884
KEY,509819,600,18.2900,300,18.2800,18.2800,505620,4199
M,506184,1400,12.4900,3900,12.4800,12.4850,465259,40925
ONTX,505681,100,0.7391,1400,0.7390,0.7390,428879,76802
NFLX,505135,15,580.0000,13,579.7400,579.8500,489908,15227
DIS,503624,15,172.0800,4,172.0300,172.0600,488995,14629
WMB,503239,146,21.8200,700,21.8100,21.8150,494203,9036
SPWR,500886,100,43.7900,300,43.7300,43.7800,489167,11719
CCIV,494008,400,17.9300,4,17.8900,17.9200,427374,66634
WWR,493725,902,6.8500,100,6.8200,6.8500,474119,19606
PBR.A,492821,14172,10.2800,15189,10.2700,10.2800,479131,13690
CLF,489415,2200,16.3900,169,16.3800,16.3900,475524,13891
AA,487715,252,20.1400,100,20.1300,20.1300,480646,7069
NAOV,481825,300,1.2700,200,1.2500,1.2600,464833,16992
QS,480339,81,50.1700,100,49.8600,49.9800,469406,10933
ICLN,480137,5600,32.6400,153,32.6300,32.6300,458632,21505
BA,474389,50,207.3900,109,207.2600,207.3300,466009,8380
BPY,474341,2300,17.1100,800,17.1000,17.1100,465503,8838
GHSI,468290,1900,0.8060,700,0.8021,0.8049,441268,27022
SHIP,466940,500,0.9690,100,0.9600,0.9643,457575,9365
SUNW,466071,100,19.2800,119,19.1900,19.2800,454728,11343
XPEV,465943,200,54.0500,100,53.8200,54.0500,455094,10849
NSPR,459904,100,0.7468,200,0.7390,0.7392,381212,78692
LI,458837,500,35.4500,100,35.3600,35.4100,434874,23963
ON,458728,200,37.8100,300,37.7900,37.8000,450906,7822
SH,455876,78160,17.4500,75600,17.4400,17.4500,455876,0
ECOR,455616,2200,2.6600,826,2.6100,2.6200,434565,21051
FTOC,455468,500,13.0900,400,13.0600,13.0700,401672,53796
IQ,454345,800,20.9200,400,20.9100,20.9100,450351,3994
IEFA,445544,7180,71.4000,10400,71.3900,71.4000,421222,24322
SRNE,444355,820,10.0600,301,10.0500,10.0600,427572,16783
AMRS,442924,2100,10.2500,200,10.2400,10.2400,431652,11272
EOG,442761,600,55.2800,100,55.2600,55.3000,424979,17782
OIBR.C,442068,2600,2.0200,11363,2.0100,2.0200,441668,400
XME,441299,3400,34.5700,1100,34.5600,34.5600,423124,18175
SQ,440352,1,221.1300,1,220.7600,220.9300,422468,17884
NCLH,439419,1100,25.2600,1400,25.2400,25.2500,416666,22753
RRC,431779,300,8.7300,100,8.7200,8.7100,425271,6508
ERIC,427883,11577,11.7400,9110,11.7300,11.7350,404606,23277
OBLN,427408,200,5.3800,100,5.3300,5.3700,357213,70195
CX,423819,4200,6.4800,5700,6.4700,6.4700,423273,546
XLY,422523,800,171.1400,750,171.1200,171.1300,416026,6497
NEM,417872,100,62.3200,1175,62.3000,62.3100,400492,17380
CPG,415539,27634,3.1900,2500,3.1800,3.1800,391956,23583
BSX,413405,700,37.6000,600,37.5900,37.6000,398987,14418
TME,412545,200,26.0200,300,26.0100,26.0000,404623,7922
MRK,411052,196,81.3700,201,81.3600,81.3700,387917,23135
TWTR,410150,300,47.1300,100,47.1100,47.1200,375935,34215
AM,408784,2083,8.1300,500,8.1200,8.1300,404709,4075
LLNW,408425,2650,4.4900,3215,4.4800,4.4850,402950,5475
GNUS,402623,18269,1.4700,5950,1.4600,1.4650,383371,19252
AIHS,402010,400,1.5400,500,1.5300,1.5300,367340,34670
VIXY,399749,4600,13.3300,1000,13.3200,13.3200,393428,6321
SPCE,398553,17,33.3800,100,33.3700,33.3600,376810,21743
MYTE,398533,200,33.1600,200,33.0800,33.2300,375507,23026
PINS,393884,305,74.2400,100,74.2200,74.2100,384361,9523
SXTC,391878,100,0.6892,700,0.6800,0.6900,375888,15990
AMAT,391506,100,107.6200,47,107.6100,107.6100,384157,7349
SYN,390997,100,0.8650,900,0.8521,0.8579,388105,2892
FOXA,389604,100,31.0600,400,31.0500,31.0600,385262,4342
USMV,388967,2500,68.0200,5300,68.0100,68.0100,381074,7893
RDS.A,388411,1500,39.7300,2500,39.7200,39.7300,382330,6081
JD,386008,200,94.9700,20,94.8700,94.9600,378458,7550
HEXO,385472,300,6.8300,100,6.8200,6.8300,381449,4023
CVX,383355,100,92.2800,100,92.2600,92.2700,364830,18525
EDIT,381328,100,64.4300,13,64.1100,64.1450,376759,4569
VTRS,380680,800,17.4400,600,17.4300,17.4300,374082,6598
MDLZ,379901,231,56.2000,472,56.1900,56.1900,367060,12841
CLNE,378463,400,10.1800,796,10.1700,10.1800,364581,13882
HL,377003,2600,5.4700,5047,5.4600,5.4700,358269,18734
PYPL,376535,200,249.2300,100,249.1200,249.1400,360892,15643
EWT,376470,5100,58.7600,1200,58.7500,58.7500,369070,7400
KR,374405,746,33.2600,1800,33.2500,33.2600,357421,16984
SDS,372229,24400,11.6800,21000,11.6700,11.6750,368629,3600
SPXS,371544,2200,35.7300,1200,35.7200,35.7300,371458,86
SYF,368381,200,38.3500,600,38.3400,38.3500,345355,23026
MRVL,364723,500,53.4300,300,53.4100,53.4200,344369,20354
AVGR,355631,2952,2.1000,304,2.0900,2.0900,344894,10737
OGI,354105,15415,1.7400,21400,1.7300,1.7350,352454,1651
AGNC,353999,335,16.1800,7104,16.1700,16.1700,349731,4268
JNJ,352569,210,161.9000,100,161.8600,161.9200,345705,6864
DISCK,350140,800,32.4600,100,32.4500,32.4500,344314,5826
ERX,349567,6200,17.8300,4100,17.8100,17.8200,313208,36359
NGL,349172,769,3.1600,300,3.1500,3.1600,335508,13664
CMRX,348649,200,9.4700,347,9.4400,9.4400,293013,55636
UNG,347848,13600,9.1800,12600,9.1700,9.1750,340143,7705
GDXJ,346432,100,51.0600,400,51.0500,51.0800,326201,20231
XLRE,344462,5400,36.7100,7200,36.7000,36.7000,310264,34198
GILD,344048,134,67.0600,206,67.0500,67.0600,337271,6777
CLNY,341616,1100,4.8100,2038,4.8000,4.8050,338744,2872
TRCH,339373,900,1.6800,13203,1.6600,1.6700,326017,13356
VEA,339328,900,48.9600,17200,48.9500,48.9550,338122,1206
ZSAN,338182,4790,1.0800,1674,1.0700,1.0750,319840,18342
FTI,336947,1363,11.2700,456,11.2600,11.2650,321723,15224
MGM,335223,100,31.5000,500,31.4900,31.5100,316234,18989
OEG,335050,217,4.1600,403,4.1400,4.1500,327467,7583
TLRY,335011,300,18.0100,300,18.0000,18.0100,293680,41331
EZU,334852,7400,45.1300,3000,45.1200,45.1200,322308,12544
BXRX,333926,2481,1.5900,1023,1.5800,1.5800,329264,4662
GPS,333340,419,22.8600,700,22.8500,22.8500,323291,10049
SMH,332918,85,244.5000,50,244.4700,244.5000,313683,19235
MKD,332413,1900,0.8819,100,0.8779,0.8779,287303,45110
EWH,331098,9018,26.4100,14325,26.4000,26.4100,299398,31700
GRTS,330682,109,25.1500,400,24.6500,24.7000,309901,20781
HYLN,329897,201,17.7200,56,17.7000,17.7100,320166,9731
TBLT,329854,2600,1.2800,1610,1.2700,1.2700,329189,665
GSK,328540,600,37.8000,1054,37.7900,37.7950,323375,5165
UAA,328114,769,18.7600,400,18.7500,18.7500,305546,22568
LPCN,326244,2700,2.2600,4000,2.2400,2.2500,315191,11053
ARKQ,324867,118,90.0700,200,90.0300,90.0700,323943,924
BIDU,324201,100,252.9800,100,252.8800,253.0200,311934,12267
OCGN,322818,1270,2.2500,864,2.2400,2.2450,316716,6102
RWLK,321199,100,2.7200,5,2.7000,2.7100,295347,25852
QID,319974,7000,25.9900,7100,25.9800,25.9900,296474,23500
WIMI,319491,100,8.6800,100,8.5900,8.6400,311106,8385
NEE,315896,100,84.2500,200,84.2200,84.2500,305658,10238
ATIF,314803,800,1.2300,850,1.2200,1.2200,304641,10162
IBM,314799,164,131.8300,164,131.7300,131.7800,279576,35223
DBX,312183,328,21.9600,700,21.9500,21.9500,308094,4089
DKNG,307297,100,53.7500,1,53.7100,53.7400,300325,6972
JCI,306467,200,52.3200,100,52.2900,52.2900,301152,5315
RF,306362,1215,17.9800,1499,17.9700,17.9700,298920,7442
V,302271,100,205.5000,200,205.4200,205.4400,290066,12205
SVXY,302119,800,41.7400,1140,41.7300,41.7400,294145,7974
NGD,299283,49615,1.9600,18122,1.9500,1.9500,295324,3959
SPXU,299224,9400,26.9900,800,26.9800,26.9850,289395,9829
CFG,299166,200,39.1800,600,39.1600,39.1700,283454,15712
JBLU,299100,1100,15.3200,1100,15.3100,15.3100,286529,12571
CLBS,296507,1300,2.5300,300,2.5200,2.5200,271734,24773
LXRX,296182,500,8.5600,400,8.5500,8.5400,289476,6706
VGK,294687,6100,62.3000,2104,62.2900,62.2900,282547,12140
DISCA,294638,300,36.8800,101,36.8700,36.8700,288307,6331
CL,294504,100,79.1400,218,79.1000,79.0800,292844,1660
GLD,294046,700,175.2000,400,175.1800,175.2000,287699,6347
EWJ,293833,1700,69.0500,2795,69.0400,69.0400,280472,13361
FITB,292018,300,30.8700,332,30.8500,30.8600,290539,1479
NVDA,291650,100,548.4600,2,548.2400,548.4800,285008,6642
MCHI,290817,200,91.1100,600,91.1000,91.1100,285619,5198
CGC,290515,100,33.7700,200,33.7500,33.7700,287846,2669
EWY,287847,1400,95.8900,600,95.8800,95.8800,280235,7612
TIGR,287477,200,18.5700,1400,18.5200,18.5100,283025,4452
IFF,286662,300,116.2500,200,116.2000,116.2000,255298,31364
ABT,285479,400,113.3700,200,113.3400,113.3500,277653,7826
LUMN,284682,1800,11.1000,1100,11.0900,11.0950,279667,5015
TLGT,283722,2150,1.1300,600,1.1200,1.1250,276103,7619
VBIV,283658,2200,3.1200,750,3.1100,3.1200,274763,8895
ALLY,283428,300,39.9900,300,39.9700,39.9800,275928,7500
PGX,282434,2900,14.9700,8400,14.9600,14.9700,232231,50203
IYE,281794,2400,22.6400,18500,22.6300,22.6400,277594,4200
TMDI,281465,100,2.3700,100,2.3600,2.3600,267899,13566
PAA,281065,1325,9.1400,1800,9.1300,9.1400,265815,15250
PCAR,280742,95,99.3000,100,99.2200,99.3000,277441,3301
UNP,279879,303,208.4000,100,208.3300,208.3350,276804,3075
RUN,279669,200,88.0000,100,87.7700,87.8100,276186,3483
TNA,279449,700,84.3500,1300,84.3000,84.3200,267619,11830
CTMX,278951,410,6.7800,300,6.7700,6.7750,236551,42400
XBI,278870,4,151.4700,50,151.3800,151.4300,267068,11802
DIA,276641,850,312.2200,1150,312.1900,312.2000,273139,3502
RSX,276553,4701,25.3600,3675,25.3500,25.3600,261213,15340
GOVT,275686,233679,27.0800,185671,27.0700,27.0700,275661,25
FSLY,274106,8,104.4300,200,104.2300,104.3700,265625,8481
NKLA,271576,200,20.1500,400,20.1300,20.1400,262929,8647
VISL,271100,100,2.5200,6879,2.5000,2.5100,266449,4651
BEST,269790,300,2.4300,1400,2.4200,2.4300,266757,3033
HST,269556,800,14.7000,900,14.6900,14.6950,264937,4619
JETS,269499,1859,22.3800,2300,22.3600,22.3800,239758,29741
TAK,267793,701,17.3500,2000,17.3400,17.3400,266756,1037
ORCL,266422,200,61.3400,463,61.3300,61.3350,243626,22796
FUTU,266334,1,97.8700,10,97.5800,97.6700,243484,22850
EFV,262603,3500,49.1600,2858,49.1500,49.1550,262103,500
AMLP,259158,420,28.0400,800,28.0300,28.0400,243993,15165
NLOK,258124,1854,20.6600,300,20.6500,20.6500,251371,6753
IJR,257556,200,100.2400,100,100.2100,100.2300,246963,10593
IPOF,257407,300,16.0400,106,16.0100,16.0200,239872,17535
SPXL,256330,500,78.4100,700,78.4000,78.3900,254478,1852
CCJ,255985,903,12.4300,500,12.4200,12.4200,237338,18647
PEP,255839,101,139.8800,95,139.8500,139.8600,251433,4406
STM,255525,300,40.5200,100,40.5100,40.5100,250996,4529
CRM,253435,64,222.6600,93,222.5600,222.5700,245777,7658
FHN,253317,1600,14.4700,800,14.4600,14.4600,246848,6469
XSPA,251444,10895,1.6300,4471,1.6200,1.6200,245629,5815
EH,251349,112,75.5000,10,75.0500,75.4900,239641,11708
ETRN,251325,2400,7.1500,800,7.1400,7.1450,245955,5370
CRNT,251001,200,5.1400,368,5.1300,5.1400,240115,10886
QD,249011,2000,2.2100,2810,2.2000,2.2000,247511,1500
TECK,248994,900,20.6100,501,20.6000,20.6050,242587,6407
SBUX,248982,100,105.1700,576,105.1400,105.1600,245785,3197
PAVE,248198,300,22.4700,659,22.4500,22.4550,245153,3045
XRT,247976,300,73.4100,400,73.3900,73.4000,239715,8261
ISR,246533,100,2.4600,4000,2.4300,2.4400,241862,4671
TCOM,245971,100,33.9400,200,33.8800,33.8800,242916,3055
BFT,245879,500,18.5500,100,18.4500,18.4900,229632,16247
DFS,245758,126,94.3700,53,94.3100,94.3400,234215,11543
IEF,245724,6747,118.3600,16375,118.3500,118.3600,232624,13100
BIGC,240272,100,70.3800,1,69.9300,70.1600,228704,11568
XLC,239637,2500,68.9200,2600,68.9100,68.9100,232525,7112
GHIV,239092,200,11.2400,100,11.2200,11.2400,234572,4520
HD,237750,50,280.1300,100,280.0600,280.1200,233454,4296
UAVS,237710,100,13.9500,300,13.8100,13.8300,215865,21845
PFF,237706,2321,38.3200,4120,38.3100,38.3200,231197,6509
AMZN,237333,100,3320.5000,4,3318.9000,3319.5100,231591,5742
IAG,237014,43724,3.4300,22125,3.4200,3.4300,232560,4454
ABBV,235181,108,111.0700,109,111.0400,111.0900,231454,3727
QCOM,233984,200,164.4500,9,164.4200,164.4200,225736,8248
TEVA,233795,1577,12.0500,1000,12.0400,12.0450,225898,7897
FOX,231781,100,30.0300,100,30.0200,30.0400,231378,403
VNM,230225,312,18.3600,195,18.3200,18.3400,229625,600
ORC,228974,3900,5.4400,1400,5.4300,5.4350,190793,38181
EPD,228865,1800,22.4600,300,22.4400,22.4500,225816,3049
EQNR,228865,2000,19.5300,2300,19.5200,19.5300,220365,8500
NOV,228051,589,13.3700,738,13.3600,13.3700,222654,5397
LUV,226076,384,47.7500,24,47.7300,47.7400,217231,8845
TMBR,225372,725,1.1200,2112,1.1100,1.1150,216608,8764
CDEV,225278,2016,2.3100,2500,2.3000,2.3050,220978,4300
VRT,225248,601,20.6400,310,20.6300,20.6400,223541,1707
PAAS,224458,500,30.7400,100,30.7200,30.7600,221235,3223
RWT,223660,600,9.3400,2600,9.3300,9.3400,216854,6806
ZNTE,223355,100,12.5800,5,12.5200,12.5200,187458,35897
GOOS,223057,100,31.7400,400,31.7200,31.7600,220656,2401
BBL,222983,200,58.9700,300,58.9600,58.9600,210641,12342
LVS,222735,100,55.2800,302,55.2500,55.2600,220030,2705
JMIA,221477,100,46.3800,100,46.2800,46.3200,215494,5983
CRON,219813,700,10.8400,500,10.8300,10.8300,212038,7775
EBAY,219567,36,56.1900,280,56.1700,56.1750,209299,10268
IBN,219153,2100,15.3800,1206,15.3700,15.3700,216476,2677
SRTY,219149,5990,13.1900,3500,13.1800,13.1800,192761,26388
CSX,219137,300,91.4400,211,91.4200,91.4300,213527,5610
MBT,217754,1600,9.2000,2800,9.1900,9.1950,212594,5160
INFY,217142,2000,18.2300,1600,18.2200,18.2250,213187,3955
ERJ,216968,4900,6.6800,1000,6.6700,6.6700,212494,4474
WY,216745,434,33.3500,1300,33.3400,33.3400,210431,6314
USWS,216216,700,0.7400,600,0.7300,0.7400,214716,1500
SABR,215644,600,12.2300,1010,12.2200,12.2250,209220,6424
CIG,215616,22462,2.6300,3300,2.6200,2.6200,205796,9820
NYMT,215476,10700,3.9300,11500,3.9200,3.9200,213788,1688
PAGP,214467,1799,9.4100,400,9.4000,9.4000,208763,5704
VNQ,211737,1600,85.5700,400,85.5600,85.5600,201979,9758
NDRA,211601,100,2.1200,400,2.1100,2.1050,204442,7159
ALXN,211573,100,158.2600,40,158.2500,158.2500,207208,4365
SAVE,211363,100,27.4200,200,27.4000,27.4100,200923,10440
MO,209495,416,41.9200,300,41.9100,41.9300,190819,18676
CTVA,209177,300,41.4800,200,41.4600,41.4700,203269,5908
EXPE,208429,2,139.8900,100,139.7500,139.7900,206799,1630
BTBT,207839,3,16.4700,7,16.4300,16.4100,191471,16368
PLTK,207097,100,30.9500,1,30.8200,30.9550,206943,154
AIG,206312,100,41.4400,400,41.4300,41.4500,204526,1786
TJX,204868,400,68.2400,100,68.2300,68.2400,201972,2896
XHB,203887,700,63.4200,300,63.4100,63.4000,200527,3360
EGO,203764,1104,11.2900,393,11.2800,11.2800,196963,6801
FSLR,203746,38,107.3400,400,107.1600,107.3100,191841,11905
VOD,203023,3725,17.6600,2250,17.6500,17.6550,200021,3002
VNET,202712,100,39.0600,2,38.9500,38.9300,200150,2562
SPLV,202248,4890,56.4600,1800,56.4500,56.4400,199077,3171
JPST,201992,67958,50.8100,41466,50.8000,50.8050,201992,0
GTE,201986,300,0.5100,1500,0.5083,0.5099,195761,6225
LLY,201344,9,203.0700,100,202.9900,203.0000,196265,5079
THMO,201225,200,2.7600,300,2.7300,2.7500,197891,3334
USO,200269,3100,35.8400,1100,35.8300,35.8400,187285,12984
KHC,200266,500,32.8100,810,32.8000,32.8100,194301,5965
PCG,199877,3400,11.9800,1100,11.9700,11.9850,195488,4389
AU,199786,300,23.3200,400,23.3000,23.3200,192757,7029
ING,199654,4900,9.4800,21300,9.4700,9.4800,196254,3400
OVV,198760,300,16.8800,400,16.8700,16.8900,191951,6809
ANGL,198485,100,32.3100,5000,32.3000,32.3100,195835,2650
TFC,198322,7,51.6600,203,51.6300,51.6400,196805,1517
TRP,197853,200,45.4700,500,45.4600,45.4700,189929,7924
COTY,197270,1220,6.9100,1676,6.9000,6.9050,193795,3475
LU,196208,800,15.7400,100,15.7200,15.7400,189487,6721
CAG,196083,100,34.0000,810,33.9900,34.0000,188975,7108
FRSX,194394,100,8.9600,100,8.8700,8.9000,187251,7143
SID,194343,8900,6.2100,2800,6.2000,6.2100,173203,21140
WBA,194094,100,47.2600,100,47.2300,47.2300,184306,9788
JNK,193879,1579,109.2200,5200,109.2100,109.2150,190902,2977
MAC,193723,600,13.4700,100,13.4600,13.4600,175042,18681
PBF,193442,502,8.0500,1000,8.0400,8.0400,188269,5173
GSX,193093,202,77.5000,100,76.9400,77.2600,183549,9544
TGT,192619,58,191.9300,277,191.8300,191.8600,189095,3524
TAN,192069,6,121.4300,400,121.2500,121.3300,183473,8596
CHNG,191919,303,24.0500,1200,24.0400,24.0500,191719,200
ACTC,191670,100,26.2400,264,26.1800,26.2100,187037,4633
SOXS,190856,2800,12.6300,1000,12.6200,12.6200,185556,5300
TTM,190027,3,20.0600,600,20.0500,20.0600,167569,22458
HMHC,189636,500,5.4800,761,5.4700,5.4700,187361,2275
BRFS,189243,13950,3.7700,16700,3.7600,3.7650,189243,0
PBCT,188813,2313,14.2200,2263,14.2100,14.2100,186984,1829
INDA,188694,2400,41.8600,3300,41.8500,41.8550,187394,1300
NVIV,187865,1750,1.3000,4900,1.2900,1.2950,181606,6259
VET,187319,3100,5.6900,900,5.6800,5.6800,179519,7800
UNH,187044,100,355.0500,100,354.8900,355.0300,177900,9144
CNQ,186848,700,24.6000,1900,24.5800,24.5900,179362,7486
UPRO,186525,800,83.4500,500,83.4300,83.4300,184862,1663
AMRN,186215,1400,6.3700,600,6.3600,6.3600,181050,5165
IVV,185941,200,386.2000,682,386.1700,386.1600,167934,18007
CAN,185940,200,4.7700,162,4.7600,4.7700,179773,6167
NKE,185758,100,141.3900,9,141.3300,141.3200,177143,8615
WDC,185704,200,53.4600,300,53.4100,53.4200,183812,1892
CBAT,185421,400,7.3000,100,7.2200,7.2900,182979,2442
EWG,185257,1827,32.6200,10001,32.6100,32.6100,175944,9313
AIKI,184951,800,1.2200,2600,1.2100,1.2100,183263,1688
RTX,184144,100,68.3800,300,68.3700,68.3700,174958,9186
VST,184143,1200,21.3700,246,21.3600,21.3600,180956,3187
PSTG,183785,200,23.3500,400,23.3400,23.3500,180619,3166
CSIQ,183077,1,63.5600,100,63.3500,63.4300,178497,4580
BCS,182847,12200,7.9100,5450,7.9000,7.9000,178497,4350
CXW,182703,100,6.8300,1500,6.8200,6.8300,179512,3191
TPH,181921,100,20.8300,298,20.8200,20.8200,176830,5091
BLNK,181905,100,45.9300,100,45.7600,45.8600,171943,9962
PDBC,181103,3000,15.9400,8800,15.9300,15.9400,180903,200
JNPR,180894,1193,25.3000,600,25.2900,25.2900,175854,5040
SPWH,180814,200,17.5600,500,17.5500,17.5550,179014,1800
ESGC,180478,800,2.1100,1100,2.1000,2.1050,163057,17421
WKHS,180067,74,23.0700,200,23.0400,23.0300,174713,5354
FNB,179697,4025,10.4700,1156,10.4600,10.4600,177282,2415
CYH,179307,300,10.0400,700,10.0200,10.0300,177415,1892
SDC,179265,500,10.8900,300,10.8800,10.8900,177820,1445
SDOW,179030,6300,11.9300,5500,11.9200,11.9350,164196,14834
PTE,178664,1000,1.1000,1300,1.0900,1.1000,157080,21584
WMT,178395,200,144.9100,100,144.8800,144.8800,175248,3147
LYFT,178392,100,48.1400,200,48.1200,48.1100,175869,2523
HPQ,178212,790,25.3900,1200,25.3800,25.3900,173987,4225
EMB,178153,600,113.7600,1100,113.7400,113.7500,161441,16712
ACRX,178080,700,1.9400,2290,1.9300,1.9300,174780,3300
TANH,177593,600,1.8800,2100,1.8700,1.8800,172314,5279
HWM,176740,100,26.9100,100,26.8900,26.9000,172935,3805
DARE,176640,800,2.8900,1,2.8800,2.8800,141677,34963
ALRN,176315,585,2.1300,1300,2.1100,2.1300,155752,20563
LAZR,175988,200,32.8300,3,32.7100,32.7000,165460,10528
TBT,175796,10650,17.8200,19850,17.8100,17.8300,159796,16000
DDD,175733,10,31.9900,307,31.9400,31.9600,160564,15169
IVZ,175676,700,21.1300,600,21.1200,21.1300,170201,5475
MBRX,174443,700,1.0200,700,1.0100,1.0200,173843,600
YPF,173109,500,3.3700,100,3.3600,3.3600,169463,3646
KOS,173099,2960,2.5500,4300,2.5400,2.5450,168279,4820
ACWI,172841,1800,94.2900,1300,94.2800,94.2500,163204,9637
TWO,172754,1500,6.5400,6775,6.5300,6.5300,169654,3100
FSR,172560,500,15.1800,1,15.1300,15.1500,148755,23805
DYN,172398,4,21.6600,100,21.6000,21.6500,161047,11351
MTUM,172296,200,170.6600,410,170.6500,170.6400,170224,2072
AKBA,171438,1200,3.2200,2550,3.2100,3.2100,165794,5644
PACB,170544,200,36.6600,100,36.6400,36.6300,169020,1524
IPG,170456,644,24.7900,400,24.7800,24.7850,168026,2430
ZM,170244,20,381.2900,10,381.0000,381.4100,164538,5706
MTG,170199,528,13.2900,1500,13.2800,13.2850,165307,4892
PDD,170112,289,173.4900,8,173.3300,173.3600,162001,8111
CLVS,169398,600,6.4800,820,6.4700,6.4800,163474,5924
BILI,169389,26,124.8200,100,124.3800,124.4000,168176,1213
CNC,168733,100,62.9000,180,62.8600,62.8900,165454,3279
CRDF,168665,250,11.3700,1300,11.3500,11.3700,141111,27554
GLUU,168633,700,9.6400,600,9.6300,9.6300,164187,4446
DRH,168608,610,8.9100,1805,8.9000,8.9100,165407,3201
TOPS,167999,300,1.6600,1349,1.6500,1.6600,167509,490
IPWR,167982,100,13.7000,100,13.4900,13.5800,151691,16291
TXN,167807,66,174.3500,166,174.2700,174.2800,164920,2887
LEN,167320,100,83.9500,100,83.9000,83.8900,162402,4918
MDT,167197,19,117.9400,171,117.9100,117.9000,165022,2175
ATVI,167093,100,94.6000,100,94.5500,94.5600,159314,7779
DHI,167014,100,76.5900,100,76.5400,76.5700,163718,3296
RKT,167003,900,19.9900,753,19.9600,19.9600,156667,10336
IPOE,166454,300,22.1700,100,22.1200,22.1500,154147,12307
QEP,166156,7700,3.0100,100,3.0000,3.0000,146765,19391
CDE,165710,1000,8.7300,1562,8.7200,8.7200,158605,7105
WPM,165654,300,40.4700,202,40.4500,40.4700,163999,1655
CSCW,165561,600,0.8868,500,0.8714,0.8713,157261,8300
AUPH,165538,300,15.1600,400,15.1200,15.1300,161982,3556
IEI,165129,17300,132.4800,1200,132.4700,132.4700,124129,41000
CVS,165063,143,74.1400,201,74.1200,74.1400,160224,4839
SPI,164913,5,11.2800,100,11.2200,11.2300,154705,10208
KOPN,164868,716,3.8000,100,3.7800,3.7800,159024,5844
UA,164347,700,16.1400,400,16.1300,16.1400,151580,12767
NAK,163832,1900,0.5250,1500,0.5243,0.5250,145804,18028
MTDR,163564,56,15.0100,2,14.9900,15.0200,155664,7900
DOYU,163258,100,12.6000,400,12.5900,12.6000,163049,209
REM,162621,400,32.5200,1900,32.5100,32.5100,124457,38164
PEIX,161847,1142,6.4100,100,6.4000,6.4000,148268,13579
GOOGL,161774,10,1893.0000,1,1892.2900,1892.7100,158142,3632
EQT,161466,700,15.9900,100,15.9700,15.9800,150997,10469
SM,161010,300,8.3300,503,8.3200,8.3300,153400,7610
AES,160698,600,27.4400,500,27.4200,27.4400,156756,3942
ENB,160637,1800,35.1100,400,35.1000,35.1000,150407,10230
ARKW,160615,400,163.6800,400,163.6000,163.6500,160613,2
AMJ,160282,2900,15.1900,4102,15.1800,15.1900,148144,12138
MA,159517,100,335.0800,200,335.0100,335.0100,156520,2997
BWA,159511,100,43.7700,300,43.7400,43.7400,152440,7071
PTEN,159425,3094,5.9600,1465,5.9500,5.9550,156263,3162
SKT,157715,565,12.3100,200,12.3000,12.3100,150251,7464
FEYE,157703,200,22.7100,200,22.7000,22.7050,137116,20587
SLM,157005,800,13.6300,500,13.6200,13.6200,149834,7171
MET,156758,400,51.4000,25,51.3900,51.4000,148886,7872
STX,156669,100,62.6000,80,62.5300,62.5600,150311,6358
OPK,156468,1300,4.4200,2200,4.4100,4.4100,146851,9617
AEZS,156250,500,0.7670,900,0.7605,0.7645,151480,4770
VIVE,155875,100,3.4800,245,3.4300,3.4500,150475,5400
ENPH,155834,2,213.8300,100,213.2300,213.3600,153331,2503
LTHM,155833,200,21.6700,400,21.6500,21.6600,150566,5267
BBY,155582,100,114.8100,3,114.7400,114.8300,150379,5203
LOW,155552,300,173.1200,100,173.0600,173.0300,153530,2022
PHM,155142,100,47.7100,200,47.6900,47.6700,151836,3306
ZTO,154663,100,32.4900,100,32.4600,32.4600,145813,8850
VEU,154476,2800,61.3400,3300,61.3300,61.3300,146020,8456
UUUU,154435,1400,3.8400,400,3.8300,3.8300,146067,8368
AXP,153876,77,127.4800,421,127.4300,127.4600,146966,6910
FCG,153845,4300,10.3800,1200,10.3700,10.3800,153745,100
EWW,153686,300,43.6200,307,43.6000,43.5900,147231,6455
KBE,151962,1500,45.3200,2800,45.3000,45.3200,146555,5407
VOO,151615,200,353.7000,700,353.6700,353.6700,147416,4199
DM,151500,210,24.0300,200,23.9400,23.9500,136095,15405
CNX,151321,504,12.3700,400,12.3600,12.3700,143061,8260
VCIT,150944,600,96.4500,1831,96.4400,96.4400,149790,1154
SONO,150638,100,28.2100,300,28.1900,28.2000,149832,806
TMHC,150494,60,29.6800,100,29.6300,29.6400,147275,3219
MPW,150144,814,21.7400,400,21.7300,21.7350,145363,4781
FOLD,149144,49,20.2600,200,20.2500,20.2500,132345,16799
OPEN,149121,400,30.2100,100,30.0100,30.0300,141727,7394
NTES,149053,6,115.8800,100,115.8300,115.8100,144813,4240
STLA,148920,529,16.7700,300,16.7600,16.7700,144292,4628
STL,148668,112,19.6400,522,19.6300,19.6350,147326,1342
FUV,148558,100,22.7600,200,22.6500,22.6800,142760,5798
EXC,148294,200,43.1100,400,43.1000,43.1000,138851,9443
VFF,148247,100,13.0800,200,13.0600,13.0700,141806,6441
PCY,147966,3494,28.1800,4686,28.1700,28.1800,141271,6695
CLR,147231,201,19.0800,196,19.0400,19.1000,141125,6106
NNOX,147191,100,65.0000,100,64.5600,64.9100,143925,3266
SEEL,146963,100,2.3300,910,2.3100,2.3100,141211,5752
MVIS,146349,300,6.7800,508,6.7600,6.7900,144055,2294
SPLG,146250,16100,45.2400,17500,45.2300,45.2100,92645,53605
LBTYK,145641,600,24.6600,200,24.6500,24.6500,144638,1003
FSM,145404,700,7.3100,1014,7.3000,7.3100,134968,10436
SAN,144572,22225,3.2300,35425,3.2200,3.2250,144572,0
MIK,144536,100,15.5100,424,15.5000,15.5100,137316,7220
EXPR,144490,2600,1.1900,3000,1.1800,1.1800,141254,3236
HPE,144486,1100,12.2700,2300,12.2600,12.2650,138271,6215
VYGG,144300,100,11.0500,100,10.9600,11.0000,144300,0
KNDI,143984,1700,8.3500,1900,8.3300,8.3300,138661,5323
QLD,143959,200,124.5200,300,124.5000,124.4900,141759,2200
IZEA,143079,400,4.2700,909,4.2400,4.2500,135785,7294
CCO,142813,1600,1.7400,1126,1.7300,1.7350,138913,3900
KODK,141036,900,9.3400,10,9.3300,9.3400,137836,3200
AMCR,140887,100,11.3100,4825,11.3000,11.3100,139700,1187
CARR,140832,220,39.7200,100,39.7100,39.7100,139980,852
VTGN,140784,4400,2.0900,360,2.0700,2.0750,134504,6280
TXMD,140127,2400,1.4800,5300,1.4700,1.4750,140127,0
NVTA,139388,100,53.8100,100,53.7600,53.7800,134992,4396
VTI,139337,600,201.5600,400,201.5400,201.5400,133909,5428
LMND,138053,284,149.1700,37,148.3200,148.9000,133895,4158
RDS.B,137901,400,37.7800,300,37.7700,37.7850,133370,4531
CERS,137558,700,7.2700,200,7.2600,7.2700,137034,524
PK,137302,101,18.0300,1900,18.0200,18.0200,122180,15122
ISBC,136868,1014,11.5500,1200,11.5400,11.5450,135468,1400
FLIR,136374,4,54.3000,100,54.2800,54.2900,122815,13559
GEN,136144,200,0.7000,700,0.6991,0.6996,135381,763
EWA,136084,3331,25.0300,10500,25.0200,25.0300,126934,9150
MCD,135754,103,214.2000,228,214.1600,214.1600,133057,2697
SOS,135518,200,2.0600,200,2.0400,2.0450,123800,11718
VLO,134999,200,59.1400,100,59.0800,59.1000,132716,2283
BDN,134600,300,11.6100,368,11.6000,11.6100,131172,3428
NRZ,134110,2575,9.8300,3075,9.8200,9.8200,128572,5538
ETM,134005,400,4.1300,353,4.1200,4.1200,130605,3400
BRX,133532,345,17.1200,300,17.1100,17.1200,127431,6101
FISV,133491,209,109.0300,50,109.0100,109.0300,130881,2610
HOME,133421,4,24.9700,85,24.9200,24.9550,127509,5912
FIS,133155,44,133.2300,44,133.1200,133.1800,129729,3426
GOOG,133048,1,1900.6400,100,1899.5700,1900.3100,130557,2491
QSR,132511,100,60.6800,123,60.6600,60.6100,131987,524
MP,131960,200,34.5600,100,34.5000,34.5300,79833,52127
SPG,131716,10,95.2400,100,95.1400,95.1600,130400,1316
ROKU,131565,182,426.9500,5,426.0700,426.6600,130232,1333
SESN,131198,1200,1.6500,8400,1.6400,1.6500,122315,8883
AIM,131124,300,2.1200,2100,2.1100,2.1200,129741,1383
COG,130874,100,18.3600,401,18.3500,18.3600,123460,7414
HMY,130764,2825,4.4500,3806,4.4400,4.4450,123763,7001
CLOV,130315,200,13.6800,300,13.6400,13.6300,120115,10200
INFI,130125,100,3.8200,300,3.7900,3.7900,123782,6343
PPL,129988,100,27.8000,722,27.7900,27.7900,124651,5337
BRK.B,129329,241,235.0400,100,234.9800,235.0200,127457,1872
FPE,129256,1841,20.2500,1500,20.2400,20.2500,112579,16677
INVH,129020,389,30.0500,431,30.0400,30.0500,121019,8001
POLA,128812,100,16.0100,100,15.8700,16.0200,124525,4287
GUNR,128763,1700,34.9900,1100,34.9800,34.9800,128763,0
GS,128264,234,289.8300,100,289.7200,289.7200,126374,1890
HSBC,128241,800,28.4300,1000,28.4200,28.4200,120815,7426
XELA,128183,2582,1.0100,7310,1.0000,1.0100,123353,4830
TTOO,128017,1650,1.9000,4700,1.8900,1.8950,123831,4186
MUFG,127978,4100,4.7300,10006,4.7200,4.7200,127978,0
MT,127914,816,23.1500,26,23.1200,23.1300,116663,11251
MOTS,127882,2900,1.6000,100,1.5300,1.5600,125219,2663
UAMY,127525,1200,0.8900,300,0.8750,0.8750,116133,11392
OUT,127215,300,18.2100,328,18.2000,18.2100,122907,4308
STCN,126777,900,2.6500,291,2.6100,2.6100,125174,1603
CNHI,126448,4500,13.8500,600,13.8400,13.8400,125821,627
IP,126227,124,52.1400,100,52.1200,52.1300,124924,1303
JDST,126182,1900,10.5200,6800,10.5100,10.5100,116682,9500
MGNI,125976,42,36.5800,300,36.4100,36.5400,124253,1723
MNKD,125609,10400,3.4500,1398,3.4400,3.4350,121320,4289
LX,125429,300,6.6800,183,6.6700,6.6750,120326,5103
IPOD,125410,100,17.8300,100,17.7600,17.8300,118324,7086
VUZI,125201,100,10.9000,100,10.8500,10.8400,124621,580
FE,125012,800,31.2200,300,31.2100,31.2150,118682,6330
SKLZ,124753,1400,29.0900,209,29.0500,29.0700,121360,3393
NUAN,124749,100,50.0900,100,50.0700,50.0900,124177,572
VTV,124564,600,122.7100,400,122.6900,122.7000,119996,4568
YINN,123961,300,28.0200,400,28.0100,28.0200,114113,9848
PEAK,123739,344,29.8700,900,29.8600,29.8700,114201,9538
ADT,123653,900,9.1400,1100,9.1300,9.1300,119408,4245
BTU,123399,612,3.4800,100,3.4700,3.4700,107922,15477
CYRX,123089,5,72.6500,100,72.5200,72.5200,117538,5551
RIDE,122724,141,24.0000,103,23.9100,23.9600,116545,6179
SPPI,122513,701,4.0000,1151,3.9900,3.9900,111843,10670
SITC,122423,880,11.1100,101,11.1000,11.1000,119068,3355
MFA,122372,4500,3.9200,5800,3.9100,3.9150,121947,425
CNP,122287,1100,21.7300,609,21.7200,21.7300,116163,6124
VYNE,122004,604,1.9100,900,1.9000,1.9000,121404,600
ACAM,121538,100,12.7000,200,12.4100,12.5600,121092,446
BOXL,121392,700,2.2100,1300,2.2000,2.2100,110708,10684
TRIT,121310,1,7.5900,250,7.5700,7.5750,111362,9948
PSQ,120836,40880,13.8100,30200,13.8000,13.8100,120659,177
COCP,120619,100,2.2800,600,2.2600,2.2700,119219,1400
ETSY,120590,101,214.1500,101,214.0000,214.0600,118777,1813
SONM,120528,1700,0.8950,600,0.8923,0.8922,111577,8951
EA,120351,99,145.4400,225,145.3300,145.3300,118986,1365
EWU,120128,1000,30.8600,6900,30.8500,30.8600,119512,616
VFC,119430,315,84.0500,2,84.0100,84.0300,111310,8120
SBS,118973,1072,7.5600,1500,7.5500,7.5600,118772,201
IGV,118531,5,358.9500,100,358.9200,358.9300,112493,6038
VGAC,118417,200,13.9500,100,13.9300,13.9300,111418,6999
COF,118079,100,107.9500,100,107.9200,107.9400,115501,2578
GIK,117994,901,16.0600,100,16.0000,16.0600,104002,13992
AMX,117946,1502,14.2100,1000,14.2000,14.2050,115914,2032
TWNK,117673,1200,14.0200,400,14.0100,14.0000,116948,725
UBS,117564,5300,14.9500,3676,14.9400,14.9450,112856,4708
SPIB,117081,2800,37.0200,4900,37.0100,37.0100,117081,0
RBAC,117032,300,11.0700,100,11.0200,11.0700,106960,10072
AGG,116962,1140,117.2500,3500,117.2400,117.2500,115929,1033
ILF,116695,1200,29.0200,2500,29.0100,29.0200,109995,6700
AXU,116670,3600,2.6900,337,2.6800,2.6900,107564,9106
DOW,115840,200,57.8000,200,57.7800,57.7900,113260,2580
CAT,115796,200,193.1100,100,193.0300,193.0700,111995,3801
DXC,115646,101,29.4500,100,29.4400,29.4500,114420,1226
BRQS,115469,5740,1.2000,10402,1.1900,1.1950,113629,1840
AVTR,115360,100,30.5600,700,30.5500,30.5600,112856,2504
FDN,115204,208,223.2300,100,223.1700,223.1800,114904,300
WU,115105,405,22.0700,200,22.0600,22.0700,111584,3521
CFMS,114882,1348,1.3500,7000,1.3100,1.3300,113432,1450
VSPR,114853,400,11.2300,100,11.1600,11.1700,75151,39702
AGI,114735,375,8.0500,3875,8.0400,8.0450,110058,4677
EMLC,114608,2000,32.9600,1455,32.9500,32.9550,79844,34764
PENN,114522,39,107.0300,100,106.9100,107.0100,113979,543
HON,114225,105,205.7300,100,205.6000,205.6300,109557,4668
EXK,114049,11700,4.5900,2101,4.5800,4.5800,105361,8688
SCO,113948,8200,9.8800,6500,9.8700,9.8950,113138,810
GPRO,113821,400,8.9000,1107,8.8900,8.8900,109071,4750
NGA,113398,100,28.6000,100,28.3900,28.5900,109723,3675
BX,113265,11,65.6300,100,65.6200,65.6200,109780,3485
XL,113152,200,19.3900,100,19.2900,19.2700,111320,1832
CPE,113080,800,13.6400,100,13.6300,13.6400,100145,12935
AHT,112964,2300,2.6800,500,2.6700,2.6700,111719,1245
LITE,112963,100,97.7300,600,97.5600,97.6800,110242,2721
UMPQ,112694,452,15.9100,422,15.9000,15.9000,109445,3249
VRM,112560,200,37.0700,50,36.9200,37.0000,107270,5290
DFH,112156,100,20.8200,100,20.6200,20.6400,99827,12329
TRMB,112092,1,70.0200,21,69.9700,69.9800,109723,2369
OPGN,111968,800,2.3400,200,2.3200,2.3400,111543,425
CRSR,111945,100,35.9300,100,35.9000,35.9100,108954,2991
SSRM,111876,100,17.7000,300,17.6900,17.7000,107066,4810
NEX,111799,407,3.5600,500,3.5500,3.5500,108608,3191
OCX,111765,100,4.6400,100,4.6300,4.6400,99221,12544
RDN,111742,286,21.4300,500,21.3800,21.3800,110365,1377
CHX,111715,400,16.6600,300,16.6300,16.6400,111414,301
DBC,111634,11900,15.3500,20030,15.3400,15.3450,111502,132
WYNN,111578,100,109.7000,100,109.6200,109.6700,108962,2616
TGNA,111353,194,15.8000,640,15.7900,15.7900,102127,9226
UL,110934,100,60.0000,400,59.9800,59.9800,106212,4722
BYND,110885,500,133.8600,10,133.7100,133.8000,99293,11592
NWSA,110840,500,19.3100,554,19.2900,19.3000,101737,9103
GEO,110642,2300,8.6600,700,8.6500,8.6500,104778,5864
ZIOP,110533,1073,3.6600,879,3.6500,3.6600,109366,1167
IMGN,110298,288,7.7200,1100,7.7100,7.7300,107831,2467
FAST,110297,1000,48.3800,200,48.3500,48.3600,109153,1144
BE,110260,100,37.8900,100,37.8400,37.8600,106321,3939
PTON,110243,100,158.6900,2,158.2300,158.5000,106373,3870
GGB,110171,16900,4.6400,3800,4.6300,4.6300,109420,751
ENDP,110155,400,6.8800,971,6.8700,6.8700,105525,4630
MOS,110017,423,28.4500,617,28.4300,28.4550,102346,7671
SHO,109960,1002,11.2900,1006,11.2800,11.2850,106563,3397
BEKE,109921,100,73.1800,42,72.8800,73.1700,100832,9089
ABB,109734,900,30.0900,400,30.0800,30.0800,109091,643
ERF,109697,6446,3.5200,3800,3.5100,3.5200,107197,2500
SCHP,109650,900,62.1900,5000,62.1800,62.1800,97022,12628
TIP,109610,94,127.8300,2400,127.8200,127.8300,106777,2833
HIG,109450,123,51.2300,100,51.2200,51.2200,109027,423
DRVN,109093,69,29.6600,69,29.3600,29.5100,98495,10598
KDP,109003,600,31.6100,500,31.6000,31.6000,105528,3475
EXPC,108814,100,15.0800,30,15.0500,15.0500,106626,2188
HOFV,108795,300,2.0100,400,2.0000,2.0100,106317,2478
NI,107593,300,21.9700,1100,21.9600,21.9500,101688,5905
RCL,107399,72,72.9800,110,72.9300,72.9300,99871,7528
KDMN,107328,1118,4.8800,1500,4.8700,4.8700,107128,200
PXD,107235,56,130.7000,1,130.5600,130.7400,106479,756
URBN,107096,100,26.7000,100,26.6900,26.7000,106089,1007
ATHA,107007,100,20.5300,100,20.4200,20.5000,88051,18956
BHC,106845,1400,26.6700,200,26.6600,26.6600,99215,7630
MARK,106819,620,2.4600,400,2.4500,2.4500,95763,11056
ORBC,106786,100,9.2100,200,9.1800,9.2000,95040,11746
BCRX,106328,800,9.2100,795,9.2000,9.2100,101267,5061
ADBE,106228,36,472.0600,2,471.8300,471.8300,104866,1362
ACHV,106146,100,12.9900,100,12.8700,13.0000,102319,3827
EDU,105274,3,181.1000,12,180.9100,181.0200,101870,3404
SHYG,105229,2600,45.5700,3300,45.5600,45.5700,104929,300
DNMR,104849,100,38.5500,500,38.2500,38.2900,96905,7944
KSS,104782,1,45.0300,258,44.9600,44.9700,103174,1608
NBY,104757,800,1.0400,1000,1.0300,1.0400,100677,4080
FNGD,104450,4800,3.8900,5515,3.8800,3.8900,102049,2401
MITT,104404,1402,3.1500,600,3.1400,3.1400,101377,3027
RPRX,104387,100,50.3600,100,50.2900,50.3400,103367,1020
GIS,104166,105,55.1900,178,55.1700,55.1700,99421,4745
FANG,104136,100,60.7400,154,60.5600,60.6900,99028,5108
GLOG,104127,1500,4.5800,706,4.5700,4.5800,87852,16275
GLW,103919,400,38.1700,100,38.1600,38.1600,97753,6166
MAT,103749,396,18.2700,111,18.2600,18.2700,92696,11053
FDX,103604,100,254.2800,100,254.1600,254.1700,102685,919
AEM,103490,300,70.8000,100,70.7600,70.8100,98024,5466
OZON,103458,100,55.2200,200,55.1800,55.1950,102546,912
PPSI,103286,100,7.6300,100,7.5300,7.5600,100897,2389
OIS,102982,165,5.7500,200,5.7400,5.7450,97976,5006
ADXN,102840,100,13.1500,100,12.9600,12.9400,63022,39818
BQ,102736,100,10.0900,100,9.8900,9.9200,86830,15906
FTFT,102654,300,5.4900,100,5.4400,5.4300,96877,5777
GNW,102574,2115,3.0900,9204,3.0800,3.0850,102274,300
FLOT,102507,8173,50.8200,1215,50.8100,50.8100,80927,21580
QRTEA,102495,524,11.7000,1348,11.6900,11.6950,100221,2274
PRTY,102296,1000,7.1800,300,7.1500,7.1700,95758,6538
DGLY,102295,650,2.5400,1700,2.5300,2.5400,101115,1180
SFM,102213,100,21.1300,413,21.1200,21.1200,99098,3115
COST,101827,200,362.9000,190,362.7700,362.8400,100450,1377
AFL,101680,325,46.6000,461,46.5800,46.5800,97025,4655
UPS,101598,100,160.5200,100,160.4600,160.4700,99838,1760
MFC,101573,4500,19.2700,7700,19.2600,19.2600,99932,1641
NEOS,101529,100,0.8300,400,0.8235,0.8240,92330,9199
VLY,101466,1300,10.7300,772,10.7200,10.7300,99664,1802
GOEV,101204,100,17.1300,100,17.1100,17.1100,87973,13231
DTIL,101111,100,13.7800,100,13.6400,13.7600,98861,2250
AREC,100995,200,2.6800,200,2.6500,2.6700,93138,7857
MOMO,100871,597,15.4400,100,15.4300,15.4400,89259,11612
EXEL,100843,600,21.3900,200,21.3800,21.3800,99417,1426
SNGX,100704,2750,1.6400,895,1.6300,1.6300,61998,38706
TD,100577,700,58.9700,200,58.9600,58.9500,94937,5640
TRV,100577,100,148.9300,101,148.8600,148.9300,94018,6559
BVXV,100463,2,6.1500,47,6.1000,6.1500,92605,7858
W,99952,100,295.3600,100,294.0800,295.3500,76157,23795
PRQR,99878,60,5.3900,1000,5.2900,5.3500,95098,4780
CNK,99864,300,18.6100,216,18.5700,18.6100,98684,1180
INSG,99568,100,18.7400,115,18.7300,18.7500,92634,6934
BEAM,99503,100,93.8000,100,93.4100,93.7600,98331,1172
BND,99476,5600,87.3600,3500,87.3500,87.3550,97986,1490
SSO,99303,100,96.5800,1000,96.5700,96.5600,97095,2208
CTXS,99257,38,128.5500,63,128.4400,128.4500,98641,616
BLDR,99232,100,42.8400,94,42.6600,42.7800,98011,1221
EWC,99081,4700,32.0800,25400,32.0700,32.0600,94360,4721
BHP,99080,200,72.4100,13,72.3900,72.4000,93204,5876
INPX,98834,300,1.3900,1300,1.3800,1.3800,97668,1166
TRIL,98752,200,13.0000,100,12.9700,12.9800,90456,8296
HSTO,98660,100,1.1300,300,1.1200,1.1200,93130,5530
SFIX,98564,302,82.5100,100,82.4100,82.4900,97652,912
CWH,98548,1,35.2000,1,34.9900,35.0900,97099,1449
AMGN,98327,3,251.6700,244,251.5400,251.6100,93943,4384
LKCO,98052,600,0.6472,600,0.6411,0.6474,42777,55275
CLSK,97880,110,25.3100,100,25.2800,25.2000,93007,4873
SO,97842,2,60.0600,100,60.0500,60.0600,91927,5915
SRLN,97824,100,46.0800,400,46.0600,46.0700,96526,1298
ATUS,97803,100,36.1300,101,36.1200,36.1300,94981,2822
BORR,97758,700,0.9072,700,0.9001,0.9001,96848,910
PIPP,97431,3600,13.0500,178,12.9600,13.0200,91955,5476
CRWD,97373,5,221.6300,55,221.4000,221.4600,92951,4422
NETE,97119,800,14.8700,100,14.6600,14.7900,91880,5239
SBH,97113,100,14.5000,599,14.4700,14.4550,94137,2976
KXIN,97104,100,4.4500,800,4.4100,4.4500,95191,1913
HMSY,96976,110,36.7600,500,36.7500,36.7500,93549,3427
RIGL,96968,800,3.7700,1290,3.7600,3.7700,95521,1447
VRAY,96663,1098,5.3500,150,5.3400,5.3500,96164,499
VIV,96436,200,8.2400,800,8.2300,8.2300,96236,200
SEDG,96425,140,317.4600,1,315.1600,316.3000,92267,4158
IPOF+,96166,200,4.6000,100,4.5300,4.6000,94290,1876
WISH,96149,200,25.0500,31,25.0200,25.0200,74194,21955
QUAL,95977,900,117.5600,500,117.5400,117.5400,94512,1465
TBA,95915,200,12.8000,100,12.7800,12.7900,94226,1689
AQMS,95898,201,4.7000,14,4.6800,4.6900,90845,5053
CRK,95834,1200,4.6800,1800,4.6700,4.6750,93043,2791
EFAV,95726,3700,74.0400,3508,74.0300,74.0300,95391,335
ASB,95621,735,19.3700,300,19.3600,19.3700,94090,1531
TTI,95570,600,1.3500,1100,1.3400,1.3500,93487,2083
FEZ,95519,2800,42.6100,2000,42.6000,42.6000,94985,534
XRAY,95360,10,57.6900,200,57.6600,57.7000,94351,1009
XLNX,95292,100,142.0500,39,141.9500,141.9900,87818,7474
NAVI,95262,700,11.3200,569,11.3100,11.3150,94100,1162
OBSV,94908,525,4.1800,600,4.1600,4.1700,90789,4119
SJNK,94824,17169,27.1000,21300,27.0900,27.0950,94824,0
INFN,94504,100,9.6800,600,9.6700,9.6600,92711,1793
DFEN,94459,800,16.3200,800,16.3100,16.3000,91259,3200
MMM,94378,169,171.3300,11,171.2300,171.2300,90172,4206
SOL,93972,200,29.3400,100,29.1500,29.1800,92230,1742
DUST,93969,700,19.7200,1100,19.7100,19.7000,89738,4231
BBI,93915,1800,1.2400,4230,1.2300,1.2400,93601,314
CLGX,93835,100,77.0000,100,76.5200,76.7000,90634,3201
NYCB,93217,1130,10.9500,1900,10.9400,10.9450,91423,1794
SPYD,92415,2900,34.6700,3600,34.6600,34.6700,91791,624
MLCO,92405,200,16.8800,500,16.8700,16.8800,88910,3495
MAXR,92242,200,51.3900,5,51.3200,51.3450,90268,1974
UNIT,92221,800,12.7300,500,12.7200,12.7200,87137,5084
FTCH,92104,100,62.1300,16,62.1100,62.1400,90522,1582
RWM,92059,11400,23.2800,15600,23.2700,23.2900,84729,7330
WEN,91979,976,21.2600,200,21.2500,21.2500,87625,4354
BAM,91769,500,38.9800,600,38.9600,38.9600,87555,4214
VIPS,91605,200,29.8600,300,29.8500,29.8600,88507,3098
UEC,91571,1100,1.6000,1738,1.5900,1.5950,90388,1183
DISH,91447,300,32.0300,302,32.0000,32.0100,88096,3351
TRGP,91299,100,28.7100,100,28.6600,28.7000,89773,1526
NAT,91293,1400,2.8800,2200,2.8700,2.8750,74141,17152
HBI,91288,400,15.6200,500,15.6100,15.6100,86406,4882
DQ,91219,49,95.1400,100,94.5700,94.6400,89297,1922
CLDR,91126,322,14.2000,201,14.1900,14.1900,86242,4884
WTI,90999,2999,2.3100,1789,2.3000,2.3050,83426,7573
AAU,90901,700,0.6229,200,0.6103,0.6185,89801,1100
VLDR,90755,92,23.1100,1,23.0900,23.1100,86490,4265
HES,89590,100,61.0400,300,60.9700,61.0000,89087,503
BCE,89504,406,43.5700,300,43.5600,43.5900,86585,2919
RMTI,89489,4102,1.3800,1100,1.3700,1.3700,88989,500
IBB,89213,300,163.7100,300,163.5800,163.7100,84777,4436
NUGT,89143,100,67.0500,100,67.0100,67.0300,86199,2944
TMUS,89082,100,130.5600,6,130.4700,130.4900,85033,4049
WIT,89006,1000,6.5900,3100,6.5700,6.5800,88047,959
CEI,88999,1800,1.2300,1700,1.2200,1.2300,88899,100
AXL,88881,235,9.5000,200,9.4900,9.4900,83593,5288
KL,88857,100,40.4500,200,40.4200,40.4700,87168,1689
ASHR,88795,2199,43.2000,1901,43.1900,43.1950,88290,505
DB,88517,4694,11.2000,5900,11.1900,11.1950,81842,6675
NTLA,88386,100,72.3400,210,72.1400,72.1800,87933,453
ADVM,88306,100,13.6100,1,13.5600,13.6200,85111,3195
MBIO,88263,600,4.8900,623,4.8800,4.8850,86846,1417
SWBI,87959,8,17.8600,230,17.8300,17.8200,83361,4598
BZH,87875,200,19.4100,100,19.3400,19.4000,86409,1466
TWOU,87726,100,44.7100,65,44.5100,44.5400,87182,544
CDNA,87385,100,88.9700,100,88.7300,88.8700,85013,2372
VSTM,87376,3474,2.1900,2600,2.1800,2.1850,82817,4559
DRIP,87260,500,18.8800,1500,18.8600,18.8600,79660,7600
WOOF,87181,3,27.1700,200,27.1400,27.1300,84785,2396
FLR,86901,900,20.7400,200,20.7100,20.7200,85367,1534
FTOCU,86438,400,14.2800,900,14.1900,14.2400,86284,154
PVG,86356,700,10.8600,1700,10.8500,10.8600,84663,1693
ENBL,86202,200,5.6500,400,5.6200,5.6100,85570,632
DG,86172,6,207.8900,30,207.7700,207.7900,85273,899
SHLX,86164,300,11.0000,200,10.9900,11.0000,84045,2119
K,86103,100,57.6600,100,57.6400,57.6500,85988,115
CHEK,86074,1000,1.6500,2500,1.6400,1.6450,84585,1489
SSPK,85608,294,25.3200,100,25.2700,25.3200,78707,6901
SVM,85548,2750,5.9600,1000,5.9500,5.9500,85245,303
VNT,85426,100,34.2100,100,34.2000,34.2100,84147,1279
OXFD,85232,500,21.9100,2300,21.8900,21.9100,84517,715
GLNG,85198,100,11.5800,694,11.5700,11.5700,81859,3339
VXRT,85153,700,7.0000,900,6.9800,6.9900,79507,5646
DVAX,85135,900,5.0900,100,5.0800,5.0900,80935,4200
TV,85007,745,8.6100,750,8.6000,8.6050,84707,300
RIO,84888,500,82.4100,71,82.3000,82.3100,81715,3173
MGY,84871,200,8.9600,100,8.9500,8.9600,83271,1600
SSL,84557,557,10.8600,100,10.8500,10.8600,82357,2200
IOVA,84553,19,47.7000,1,47.4900,47.5200,83513,1040
UUP,84483,26200,24.3000,28700,24.2900,24.3000,84483,0
IDV,84367,1122,30.9000,1473,30.8900,30.9000,82559,1808
VCSH,84361,2900,83.1500,3400,83.1400,83.1450,83626,735
INFO,84168,122,89.0900,56,88.9600,89.0000,82512,1656
ACIW,83901,33,40.2600,100,40.2300,40.2500,74942,8959
LXP,83845,1200,10.3000,1600,10.2900,10.3000,80932,2913
ADI,83769,200,158.9300,212,158.8400,158.9000,82431,1338
BAX,83580,100,80.0500,200,79.9900,80.0100,76889,6691
KMX,83433,44,120.5100,25,120.4300,120.4200,82353,1080
MPC,82607,200,45.4000,300,45.3700,45.4000,76693,5914
MAS,82326,200,58.3900,100,58.3700,58.3500,80841,1485
MUB,82322,600,117.1300,1100,117.1200,117.1200,82300,22
IVW,82307,1,65.7600,2400,65.7500,65.7600,81607,700
SPYV,82302,5700,35.3100,11500,35.3000,35.3000,82002,300
STNE,82060,300,80.1000,15,79.9200,80.0400,80949,1111
ABEO,81958,1400,2.0300,700,2.0200,2.0300,81758,200
NMTR,81947,3505,1.2300,6000,1.2200,1.2250,74670,7277
EVFM,81914,1989,2.8100,700,2.8000,2.8100,80996,918
Z,81888,12,145.4700,1,145.0000,145.1900,79508,2380
GSAH,81886,100,12.0900,100,12.0700,12.0700,75160,6726
PACW,81463,109,30.4600,100,30.3400,30.4400,80047,1416
API,81289,200,46.6600,200,46.3300,46.4800,80150,1139
SBSW,81196,300,17.1700,200,17.1600,17.1600,79547,1649
INMB,81130,100,21.2600,400,20.9000,21.2300,80077,1053
TECS,81067,5080,7.9700,3200,7.9600,7.9800,78967,2100
OSTK,81063,100,64.4000,100,64.3100,64.2900,77374,3689
NXTD,80981,1900,1.1500,1720,1.1300,1.1400,80105,876
TDOC,80802,14,243.3600,100,242.3900,243.3700,78294,2508
OKE,80622,100,43.0900,100,43.0500,43.0800,79353,1269
BOIL,80405,600,20.4400,800,20.4100,20.4250,70515,9890
WTRH,80339,1310,3.2700,800,3.2600,3.2600,78959,1380
GSV,80260,3600,0.6650,1500,0.6563,0.6611,9135,71125
DHR,80242,100,233.5500,58,233.4500,233.5200,77297,2945
CF,80069,100,43.4100,8,43.3800,43.3900,79415,654
PD,79918,100,48.8500,100,48.8000,48.8500,79837,81
ETAC,79902,200,10.6300,100,10.5500,10.6200,67286,12616
YNDX,79535,100,68.6800,4,68.6300,68.6400,78463,1072
CS,79370,4400,13.7700,300,13.7600,13.7600,79170,200
AEP,79368,1,81.3600,100,81.3300,81.3100,78429,939
NOVA,79234,100,53.6500,100,53.5000,53.6000,77414,1820
QFIN,79161,100,15.9800,200,15.8700,15.9000,78026,1135
DADA,78863,104,42.9600,6,42.8700,42.9000,78648,215
DAN,78786,102,21.6100,700,21.5700,21.5300,77682,1104
BKLN,78705,22500,22.3800,13800,22.3700,22.3750,77897,808
PSLV,78682,1500,9.1600,2148,9.1500,9.1550,74224,4458
NWL,78225,279,24.7300,400,24.7200,24.7300,69197,9028
DNMR+,78181,100,19.0500,100,18.9000,19.0000,56531,21650
MUX,78030,500,0.9409,200,0.9404,0.9404,57320,20710
MCRB,77998,100,24.4600,20,24.2800,24.3300,77354,644
ORI,77822,300,18.7300,400,18.7200,18.7200,76113,1709
NRG,77741,100,41.1400,100,41.1100,41.1200,77356,385
EBR,77667,1300,5.8900,1500,5.8800,5.8900,77567,100
NVS,77663,103,96.9200,1100,96.8600,96.8700,74651,3012
CBOE,77625,2,95.7200,102,95.6600,95.6600,77144,481
FAZ,77450,8300,6.3400,12800,6.3300,6.3300,76471,979
TPR,77419,100,33.8600,105,33.8400,33.8500,73239,4180
TOL,77331,100,50.2200,42,50.1200,50.2050,74818,2513
TTNP,77304,100,3.2400,493,3.2200,3.2200,76121,1183
VNE,77103,200,27.5000,400,27.4200,27.4200,75352,1751
BLMN,77087,100,22.4200,5,22.3200,22.3400,73989,3098
ATI,76930,100,18.1100,101,18.0900,18.1000,74132,2798
TER,76871,2,140.3000,100,140.2300,140.2800,75157,1714
AKAM,76860,11,110.1200,4,110.0800,110.0900,73942,2918
STLD,76829,3,38.8800,165,38.8500,38.8800,76358,471
NLSN,76729,500,21.7800,800,21.7700,21.7700,72320,4409
TU,76604,800,20.9000,2300,20.8900,20.8900,75664,940
TS,76562,600,15.7800,97,15.7700,15.7700,74462,2100
PRTS,76318,200,12.8200,400,12.8000,12.8100,75358,960
MGK,75984,200,209.0500,100,209.0200,208.9900,75984,0
RAD,75960,200,19.6400,7,19.5800,19.5800,70541,5419
EWL,75946,400,45.6800,1000,45.6700,45.6700,70039,5907
CHWY,75917,31,106.1400,113,105.9800,106.0200,74248,1669
TSN,75891,5,65.8800,46,65.8500,65.8700,75404,487
ASX,75883,800,7.6300,1100,7.6200,7.6200,74883,1000
HRL,75723,100,45.1600,400,45.1500,45.1500,74005,1718
GT,75722,700,11.6400,600,11.6300,11.6400,73837,1885
HEC,75672,100,11.6100,350,11.5700,11.5700,74272,1400
ARCO,75201,200,5.5700,800,5.5500,5.5500,74821,380
APT,75099,1,13.9900,200,13.8700,13.9200,68901,6198
EMR,75018,9,84.5100,300,84.4800,84.5100,73788,1230
ONCS,74973,700,7.1200,200,7.0000,7.0300,58595,16378
LAUR,74900,32,14.3700,12,14.3500,14.3700,68198,6702
DASH,74794,200,191.0000,200,190.3800,190.6700,71882,2912
TWM,74741,5900,16.7300,10000,16.7200,16.7300,60396,14345
LGVW,74734,100,21.7100,200,21.6200,21.5500,68940,5794
BEN,74722,200,26.6000,300,26.5900,26.6000,73216,1506
AXTA,74720,489,28.4300,400,28.4100,28.4100,70105,4615
CI,74699,100,227.2800,100,227.1300,227.2000,73826,873
SAND,74690,2800,6.6800,892,6.6700,6.6800,71660,3030
WRK,74565,100,46.9500,3,46.9100,46.9200,73805,760
DRE,74520,150,39.9500,1,39.9400,39.9500,66344,8176
SMFG,74489,2630,6.5000,3300,6.4900,6.4900,74089,400
MDY,74324,600,447.9500,725,447.8400,447.9500,74324,0
EMAN,74319,200,2.7000,800,2.6800,2.6900,68836,5483
METX,74240,4000,2.1000,3900,2.0500,2.0600,71840,2400
DDOG,74115,100,103.5400,2,103.3700,103.2900,72497,1618
NG,74106,600,9.0100,400,9.0000,9.0000,66406,7700
HRB,73904,609,16.7700,405,16.7600,16.7600,70970,2934
SGMO,73880,100,14.5600,100,14.5100,14.5100,70383,3497
HASI,73760,35,69.2800,100,69.1300,69.1500,72417,1343
GRWG,73710,100,49.2900,47,48.9600,49.0400,72668,1042
DNN,73626,100,0.7100,1000,0.7070,0.7059,73426,200
KMB,73607,42,131.0800,300,130.9900,131.0000,72298,1309
XXII,73495,700,2.6500,200,2.6400,2.6500,66238,7257
ARPO,73401,800,1.3200,2500,1.3100,1.3200,71953,1448
OSTRU,73387,936,10.1700,1315,10.1500,10.1600,71055,2332
AEG,73301,6486,4.2800,14200,4.2700,4.2800,73301,0
ENG,73167,100,7.4300,1600,7.3700,7.4300,72367,800
NET,73139,100,83.7800,100,83.3000,83.3500,67952,5187
GUSH,73110,500,50.6600,1115,50.6100,50.6800,71710,1400
EQX,73096,581,10.2900,390,10.2800,10.2800,70693,2403
WATT,73089,600,3.0700,26,3.0600,3.0600,71461,1628
IWN,73071,500,142.6200,300,142.4800,142.5300,69675,3396
APTV,72939,37,144.2700,35,144.1000,144.2000,72097,842
PRNT,72889,100,39.6900,8,39.6600,39.6600,71974,915
LMFA,72829,300,1.6900,2100,1.6800,1.6900,71450,1379
D,72582,294,71.8900,100,71.8600,71.8700,71142,1440
GILT,72521,102,9.2600,200,9.2300,9.2500,53765,18756
CCX,72483,100,10.6800,100,10.6600,10.6700,65078,7405
LRCX,72470,100,561.0000,110,560.3300,560.4500,71254,1216
VEON,72264,5320,1.7800,5700,1.7700,1.7750,72114,150
WRI,72262,100,22.6400,98,22.6300,22.6300,70644,1618
NXPI,72077,100,174.3800,1,173.7900,173.9300,70995,1082
CRSP,71639,100,185.1800,200,184.8800,185.0800,70336,1303
SYPR,71540,400,2.2100,1500,2.1500,2.1700,68307,3233
EIDO,71511,900,24.9800,200,24.9700,24.9700,69611,1900
CMI,71507,135,249.8500,99,249.6400,249.7000,69104,2403
DSS,71435,300,4.0300,1005,4.0200,4.0250,63194,8241
CNDT,71361,820,5.1500,300,5.1400,5.1500,71013,348
VG,71345,200,13.2000,400,13.1900,13.2100,71006,339
NBEV,71234,500,2.8900,1302,2.8800,2.8900,70634,600
VICI,71227,1,26.2900,500,26.2800,26.2800,66581,4646
COMM,71200,100,15.0800,455,15.0700,15.0800,67604,3596
LABD,71008,1100,19.7900,300,19.7600,19.7600,70708,300
FBCG,71006,400,30.2800,7103,30.2200,30.2600,71006,0
HPP,70935,417,24.5300,4,24.5000,24.5300,68533,2402
ITOT,70764,200,89.3500,600,89.3400,89.3400,64142,6622
URG,70649,100,0.9599,200,0.9550,0.9624,63563,7086
NTR,70580,28,54.0100,100,53.9900,54.0600,66016,4564
UCO,70512,1200,42.1400,1200,42.1200,42.0800,69092,1420
DFFN,70452,490,1.1900,1200,1.1800,1.1900,66390,4062
IRWD,70181,551,10.4400,400,10.4300,10.4400,68766,1415
SPAB,70134,4660,30.5500,3300,30.5400,30.5450,68286,1848
AT,69933,8000,3.0100,5000,3.0000,3.0050,69533,400
PAVM,69930,500,2.1300,200,2.1200,2.1300,69629,301
LBTYA,69871,400,24.9900,300,24.9800,24.9900,67263,2608
BSBR,69657,2800,7.6000,1000,7.5900,7.6000,67407,2250
IRDM,69526,200,48.3000,100,48.2600,48.2800,66972,2554
FNV,69459,100,124.0000,100,123.9100,123.9500,68924,535
RESN,69168,200,6.6700,400,6.6400,6.6700,65088,4080
DHT,69121,3061,5.5200,1851,5.5100,5.5150,67812,1309
JKS,68864,100,68.4200,50,68.2600,68.3500,66970,1894
SPOT,68834,100,349.7000,100,349.1000,349.4300,63998,4836
NTNX,68706,23,33.5900,189,33.5500,33.5800,66173,2533
FJAN,68561,600,30.6200,79,30.5900,30.6100,67761,800
BOTZ,68464,4100,35.5800,1800,35.5700,35.5800,64441,4023
STKL,68389,100,13.0600,100,13.0300,13.0400,67669,720
SPHD,68190,2100,38.8200,5500,38.8100,38.8100,68161,29
DNOW,68029,200,8.2400,173,8.2300,8.2400,66133,1896
FLDM,67951,313,6.2000,400,6.1900,6.2000,66184,1767
ESNT,67931,100,46.7200,100,46.6900,46.6800,67421,510
CHS,67929,696,2.1900,400,2.1800,2.1900,67326,603
DPW,67736,334,5.0800,78,5.0500,5.0750,64919,2817
TOT,67669,600,44.1900,100,44.1800,44.1900,67208,461
ED,67541,197,69.5100,200,69.4700,69.4800,67118,423
ELY,67510,7,28.7600,100,28.7300,28.7300,66907,603
OHI,67508,100,36.0500,100,36.0400,36.0600,67308,200
GNOG,67448,900,20.4900,300,20.4000,20.4900,66532,916
YQ,67444,100,17.1000,100,16.9600,17.0000,64359,3085
LPX,67443,82,39.7700,100,39.6900,39.7100,66681,762
KBH,67333,100,41.7200,132,41.6000,41.6100,67060,273
GFL,67312,100,30.5900,314,30.5600,30.5600,66712,600
IEZ,67021,9800,12.3200,1100,12.3000,12.3100,48884,18137
SCHD,66860,7200,66.3500,2200,66.3400,66.3500,65439,1421
FBP,66527,500,9.9100,477,9.9000,9.9100,65224,1303
EAT,66392,1,61.9300,100,61.5800,61.8200,65881,511
MGA,66227,100,77.1400,438,77.0900,76.9500,62969,3258
FL,66222,1,48.1600,100,48.1300,48.1300,62177,4045
DLTR,66186,100,108.2000,303,108.1200,108.1100,65250,936
CREE,65868,100,114.8500,375,114.6000,114.7900,50356,15512
VRTX,65708,113,238.9200,24,238.7400,238.8100,64843,865
JNCE,65701,4,11.9800,100,11.9300,11.9600,65202,499
SNOW,65689,200,285.7600,201,285.5000,285.4300,64753,936
CFAC,65663,250,12.0600,400,12.0000,12.0000,63363,2300
BNTX,65497,287,106.1800,41,105.9000,106.1350,57977,7520
KLR+,65430,100,2.4200,100,2.0600,2.0000,65430,0
SINT,65335,300,2.0300,900,2.0200,2.0200,63235,2100
VCYT,65129,2,53.9000,100,53.6800,53.7800,64485,644
APPS,65052,200,62.7700,300,62.3800,62.6300,61339,3713
SPYG,65004,200,56.9800,4900,56.9700,56.9300,63915,1089
PBI,64959,800,7.0700,907,7.0600,7.0600,61221,3738
HLT,64937,1,109.2300,200,109.1500,109.2100,62325,2612
OR,64679,400,12.0300,800,12.0200,12.0250,63157,1522
GEL,64524,200,6.1200,100,6.1000,6.1100,64524,0
STAF,64302,700,0.9545,300,0.9450,0.9414,54502,9800
ACRS,64253,1,18.2300,100,18.1200,18.1900,63305,948
XRX,64183,305,21.3900,100,21.3800,21.3950,57630,6553
XEC,64163,43,44.9500,12,44.7400,44.8200,63265,898
NBSE,64100,100,8.9200,1000,8.8200,8.8400,60556,3544
WELL,64097,100,61.8200,200,61.7600,61.8000,61266,2831
THTX,64049,300,2.3700,100,2.3500,2.3600,33292,30757
LOGI,63953,5,105.1200,100,104.7000,105.0200,63505,448
DOCU,63895,100,254.6400,15,254.4600,254.6900,61917,1978
RHE,63797,100,4.0100,100,3.9100,3.9300,56022,7775
BLRX,63739,100,2.5100,600,2.5000,2.5100,60939,2800
EAF,63597,130,10.9000,200,10.8900,10.8900,61381,2216
STWD,63475,300,19.1100,400,19.1000,19.1100,58382,5093
ADM,63170,300,52.8700,110,52.8600,52.8700,61815,1355
POWW,63132,100,5.8300,100,5.7800,5.7900,49762,13370
AAXJ,62968,200,98.9800,300,98.9700,98.9600,57079,5889
MJ,62655,100,19.5500,100,19.5300,19.5300,61667,988
CFII,62583,100,12.1000,100,12.0200,12.0300,52182,10401
AZUL,62483,100,21.0700,100,21.0500,21.0700,62077,406
NIU,62424,10,46.8000,235,46.5400,46.6200,59768,2656
GTHX,62413,100,21.4800,100,21.3700,21.4900,61450,963
ZYNE,62378,500,3.6500,1000,3.6300,3.6300,59893,2485
RP,62375,100,87.2700,200,87.0600,87.0900,59619,2756
ADMA,62221,1100,2.4000,2500,2.3900,2.3950,61221,1000
HUYA,62197,123,23.6300,101,23.6100,23.6200,53714,8483
CALA,61959,500,2.9300,129,2.9200,2.9300,61524,435
NEPT,61959,3100,2.0400,2300,2.0300,2.0300,61859,100
CPRI,61955,1,43.7300,100,43.7100,43.7300,55581,6374
NTRS,61855,100,94.5900,102,94.5500,94.5900,60953,902
PLIN,61605,1000,1.1000,800,1.0900,1.1000,60506,1099
OMC,61585,300,63.3300,85,63.2800,63.3000,60769,816
PSNL,61547,50,49.8600,100,49.6500,49.7100,61136,411
AIV,61329,2100,4.7900,1963,4.7800,4.7850,61318,11
CGEN,61238,900,12.8400,100,12.7600,12.7400,58848,2390
HYLB,61226,1600,50.2200,1582,50.2100,50.2200,61226,0
PHUN,61168,904,1.3300,1100,1.3200,1.3200,50992,10176
SDY,60968,1,109.0500,600,109.0400,109.0500,60747,221
OI,60963,200,13.1800,300,13.1600,13.1700,60442,521
THC,60940,15,50.0500,100,50.0100,50.0400,59699,1241
AMT,60717,1,222.1900,176,222.0800,222.1200,57945,2772
BNS,60500,500,55.4400,200,55.4300,55.4500,56421,4079
WSC,60420,100,26.0500,400,26.0400,26.0300,60292,128
QQQJ,60273,100,33.0400,200,33.0300,33.0400,59879,394
DXD,60177,10030,11.9500,9400,11.9400,11.9350,60077,100
NWS,60170,654,18.8400,302,18.8300,18.8200,59617,553
MPLN,60148,483,7.5000,200,7.4900,7.5000,60148,0
NSC,60111,100,245.8400,112,245.7400,245.7400,59347,764
BTI,59991,400,38.0300,300,38.0100,38.0100,56552,3439
ANGI,59945,420,12.4800,300,12.4700,12.4800,58347,1598
ABUS,59888,2900,3.9800,1800,3.9600,3.9700,59135,753
PGR,59872,300,94.5300,29,94.4900,94.5200,59354,518
VIG,59823,500,141.8100,800,141.7900,141.7700,58503,1320
SPR,59820,76,39.0000,200,38.8900,38.8900,58079,1741
IJH,59759,1061,245.2800,50,245.2400,245.2500,55615,4144
CTSH,59726,200,80.9100,61,80.8600,80.9000,55030,4696
INTU,59624,26,384.4600,2,384.2100,384.2700,59134,490
KPTI,59363,101,15.1200,1300,15.1000,15.1100,57863,1500
ZS,59322,100,214.4600,105,213.7300,213.8000,58218,1104
FULT,59231,638,14.3900,100,14.3800,14.3800,55807,3424
YY,59116,100,90.7300,307,90.6900,90.6900,58512,604
VMW,59089,200,134.2900,200,134.2400,134.2500,54564,4525
XNET,59017,700,4.0100,302,3.9900,4.0000,57822,1195
IGT,58914,100,17.9400,100,17.9200,17.9300,56735,2179
HLX,58809,2300,4.4300,500,4.4200,4.4300,51808,7001
CADE,58792,331,20.4200,200,20.3700,20.4100,57867,925
NTN,58744,100,2.7700,400,2.7100,2.7100,52035,6709
OMI,58735,100,25.9700,74,25.9100,25.9500,58733,2
SIX,58695,100,36.7100,100,36.6200,36.6800,56396,2299
BLU,58619,700,3.9200,400,3.9100,3.9000,57117,1502
CIM,58609,1000,10.5200,500,10.5100,10.5200,51627,6982
RELX,58540,402,25.0900,700,25.0800,25.0800,58540,0
PRVL,58517,400,23.0500,150,23.0100,23.0400,57133,1384
BPFH,58484,400,12.6400,300,12.6200,12.6400,56283,2201
CURI,58332,100,18.8000,500,18.5900,18.7000,55743,2589
GPL,58158,500,0.8058,82,0.8040,0.8040,41921,16237
SCHF,58133,7300,37.3700,10900,37.3600,37.3600,55433,2700
USHY,58094,2985,41.3900,9757,41.3800,41.3900,57500,594
CAH,58037,198,55.2000,100,55.1600,55.1400,56254,1783
BJ,58028,200,42.5800,7,42.4700,42.4700,56266,1762
DBI,58012,220,9.3700,100,9.3600,9.3700,55548,2464
SBE,57846,190,39.9500,100,39.8000,39.8500,55158,2688
CB,57811,2,157.9800,154,157.9000,157.9700,57268,543
LCTX,57778,2400,2.7200,1200,2.7100,2.7200,57528,250
FNF,57751,26,40.0900,17,40.0700,40.0800,57695,56
ORTX,57740,200,6.2500,283,6.1900,6.2200,57325,415
PDM,57735,204,16.2300,101,16.2200,16.2200,53074,4661
BSJP,57644,400,24.4600,200,24.4500,24.4600,57154,490
XP,57448,6,42.7400,800,42.6900,42.7000,56525,923
KKR,57342,500,41.3400,500,41.3200,41.3000,40604,16738
EC,57286,700,13.9100,100,13.9000,13.8900,55222,2064
JWN,57221,100,36.1900,71,36.0900,36.1500,53446,3775
HIMX,57123,100,8.8300,500,8.8000,8.7900,54510,2613
SCHE,57122,10100,33.3900,5100,33.3800,33.3850,55222,1900
ELAN,57076,71,30.4200,102,30.3600,30.3400,55988,1088
AQB,57063,100,11.0600,101,10.9600,11.0200,55645,1418
BSV,57058,5300,82.8200,1600,82.8100,82.8200,55613,1445
EWI,57031,400,29.7100,1000,29.7000,29.7000,52078,4953
PEG,56962,301,58.7500,300,58.7400,58.7700,56577,385
USAS,56727,4400,2.6600,2992,2.6500,2.6550,56248,479
NVCN,56699,1838,1.2400,4600,1.2300,1.2300,56699,0
GXGX,56583,700,10.3700,500,10.3500,10.3600,55543,1040
CLRB,56254,997,1.9900,1000,1.9800,1.9800,55761,493
NRGD,56173,1100,4.0400,1400,4.0200,4.0300,56173,0
TZPSU,56015,400,10.3000,500,10.2900,10.3000,55115,900
HTA,55805,100,28.8800,176,28.8600,28.8500,49868,5937
URTY,55709,110,100.2400,200,100.1800,100.1900,52088,3621
LNT,55702,100,49.9100,200,49.8800,49.9000,54646,1056
BEAT,55631,300,72.2200,700,72.2000,72.2100,55431,200
MLPA,55543,300,29.8000,1800,29.7800,29.7900,47643,7900
LIT,55464,600,71.3900,100,71.3300,71.3200,50965,4499
EUFN,55308,3000,18.0200,5300,18.0000,18.0100,51703,3605
VYM,55291,800,94.6600,801,94.6500,94.6600,54788,503
FATE,55275,100,101.9200,100,101.3500,101.7900,54536,739
PERI,55127,200,13.3400,217,13.2700,13.3100,52720,2407
ATHX,55030,1200,1.8600,1238,1.8500,1.8500,39001,16029
VVV,55022,300,25.0300,1241,25.0200,25.0200,54264,758
LKQ,55016,3,37.7400,400,37.7300,37.7300,53789,1227
ARCC,54967,1000,17.5500,200,17.5400,17.5450,52973,1994
ROCHW,54926,100,6.0400,100,5.7700,5.8000,53410,1516
CZR,54894,200,81.1200,100,81.0600,81.1000,54290,604
PSX,54821,100,73.4200,100,73.3800,73.4000,53047,1774
XEL,54795,10,65.3000,50,65.2700,65.2700,53181,1614
BTAQ,54780,172,11.5000,20,11.4500,11.4650,52011,2769
REPH,54769,200,3.6800,600,3.6500,3.6800,49235,5534
PBA,54704,200,28.3600,400,28.3500,28.3400,50669,4035
CMS,54631,2,58.2700,101,58.2600,58.2700,54355,276
ABCL,54530,51,50.5100,100,50.4400,50.5100,52828,1702
PDCE,54495,100,24.5800,200,24.5300,24.5800,53564,931
LIVX,54349,200,4.2600,800,4.2400,4.2600,53874,475
PUMP,54336,100,7.8500,200,7.8400,7.8400,54164,172
PULM,54214,200,1.5500,100,1.5200,1.5300,54114,100
RSP,54162,400,132.2300,100,132.1900,132.2000,51948,2214
TGB,54132,6600,1.3300,163,1.3200,1.3200,53532,600
SPDW,54085,6000,35.1100,5900,35.1000,35.0900,54058,27
SWCH,54010,500,16.3700,400,16.3600,16.3700,53378,632
FSRV,53793,100,17.6300,600,17.5200,17.6200,47219,6574
FLRN,53721,400,30.6400,16900,30.6300,30.6350,7721,46000
BGI,53662,350,1.3000,100,1.2700,1.2800,51376,2286
PM,53634,100,81.3400,100,81.3200,81.3300,52018,1616
DUNEU,53425,200,11.0000,100,10.9800,11.0000,44679,8746
REAL,53292,100,27.6300,100,27.5500,27.5800,52593,699
EZA,53275,200,46.0200,100,45.9800,45.9900,53175,100
CROX,53271,100,73.4600,43,73.1200,73.2850,52740,531
OII,53159,100,10.2500,110,10.2300,10.2300,51146,2013
ACCD,53147,38,59.0800,100,58.8500,58.8600,52531,616
PPG,53127,100,144.3300,350,144.2600,144.3200,52462,665
WORX,53120,100,1.9800,4169,1.9500,1.9750,49110,4010
ZUO,53097,200,14.8800,600,14.8500,14.8600,51007,2090
SPMD,53077,2100,43.1100,2000,43.1000,43.0900,52077,1000
AFIN,53023,200,7.8500,400,7.8100,7.8400,53023,0
MGI,52974,200,6.0800,901,6.0600,6.0700,48798,4176
SRE,52931,130,122.9700,200,122.8800,122.9200,51480,1451
ADP,52869,10,161.3500,1,161.2900,161.3400,52540,329
WES,52863,400,15.3000,200,15.2800,15.2800,51712,1151
SWKS,52846,3,163.4000,19,163.3500,163.4100,52010,836
ACIA,52795,100,114.4700,125,114.4600,114.4650,52449,346
ESGE,52748,600,45.9100,1,45.8900,45.8900,50949,1799
REI,52719,2300,1.0600,3900,1.0500,1.0500,50036,2683
KAR,52683,100,18.5200,200,18.5000,18.5100,52326,357
DOC,52677,100,18.1300,600,18.1200,18.1200,46772,5905
SUZ,52613,700,12.2300,200,12.2100,12.2200,50608,2005
VIH,52606,100,14.7300,100,14.6100,14.7000,45185,7421
BUD,52590,100,67.7900,53,67.6600,67.7400,49400,3190
MIC,52487,300,29.2200,5,29.1900,29.1900,52486,1
SPLB,52392,400,32.2300,700,32.2200,32.2200,41992,10400
PEI,52376,200,1.9000,800,1.8800,1.8900,48574,3802
ESRT,52275,700,9.1900,9,9.1700,9.1800,49284,2991
APSG=,52117,500,11.7000,400,11.6500,11.6700,51517,600
KNX,52019,100,43.3800,100,43.3600,43.3700,51650,369
VPL,51984,100,82.6600,500,82.6500,82.6500,47300,4684
NAIL,51807,300,61.1800,200,61.0900,61.0200,51399,408
PCPL,51742,300,10.9900,100,10.9400,10.9900,49760,1982
RY,51620,200,85.3800,569,85.3600,85.3700,43835,7785
ODP,51555,100,46.4600,200,46.3800,46.4700,51455,100
ARCT,51516,100,64.0200,100,63.6800,64.0100,49321,2195
BHVN,51428,100,78.0900,146,77.6800,78.0300,50465,963
FORD,51378,500,2.7000,100,2.6400,2.5700,48726,2652
DELL,51365,1,76.8800,57,76.8100,76.8500,49803,1562
ACGL,51271,100,34.4000,122,34.3200,34.3300,48888,2383
AFMD,51255,200,6.5400,300,6.5300,6.5400,50621,634
TEAM,51232,3,237.0900,100,236.9400,237.0150,49905,1327
VVPR,51211,100,13.7400,148,13.5800,13.8000,48500,2711
SE,51091,100,235.8100,17,234.9800,235.1000,47205,3886
CIEN,50968,10,54.5500,100,54.5000,54.5500,49097,1871
LMT,50967,30,339.4200,1,339.1400,339.1800,49571,1396
ADAP,50959,208,5.5100,1000,5.5000,5.5100,50509,450
CIIC,50948,100,28.1000,100,28.0300,28.0300,43518,7430
O,50883,5,59.2200,1,59.2000,59.2300,49928,955
SPGI,50812,5,318.2900,700,318.1700,318.1800,48194,2618
VTR,50786,87,48.2600,100,48.2500,48.2600,49966,820
GRFS,50781,700,19.3800,608,19.3200,19.3100,43067,7714
HTH,50780,100,31.9500,100,31.8500,31.9800,50547,233
CRIS,50738,68,11.2800,200,11.2400,11.2700,49798,940
SLQT,50648,101,25.3600,102,25.3300,25.2900,50083,565
ADSK,50616,200,306.0200,100,305.9100,305.9400,49584,1032
AGRX,50575,500,2.9900,2200,2.9800,2.9900,50273,302
TMO,50546,39,514.8900,4,514.4200,514.5400,49676,870
STT,50494,169,74.9100,100,74.8700,74.8700,49724,770
TLND,50453,100,45.1000,500,44.9700,44.9900,48235,2218
WDAY,50407,100,229.8700,3,229.7300,229.7600,48222,2185
MTLS,50387,100,70.4300,1,70.0900,70.2600,49796,591
HUN,50378,40,28.2200,401,28.1800,28.1900,48918,1460
IBIO,50331,7155,1.4800,3500,1.4700,1.4750,45591,4740
DUK,50317,266,90.5000,400,90.4200,90.4800,47253,3064
WEI,50268,1200,1.7500,100,1.7000,1.7100,46290,3978
ZION,50168,101,47.7100,100,47.6800,47.6900,48607,1561
TAP,50090,200,50.7400,60,50.7000,50.7300,46223,3867
KBR,50049,112,31.0300,200,31.0100,31.0200,49849,200
KWEB,49936,400,89.2000,200,89.1000,89.0900,45109,4827
EQH,49892,100,27.3100,109,27.2900,27.3100,48188,1704
RBA,49877,100,62.7500,100,62.7100,62.7100,49577,300
SI,49712,300,65.1000,100,64.7200,64.8000,48469,1243
PRU,49688,59,83.2500,62,83.2000,83.2400,47880,1808
VRNT,49686,200,71.6100,100,71.5600,71.5900,49283,403
LPL,49597,200,10.6500,200,10.6400,10.6300,49288,309
AVGO,49574,29,467.7400,10,467.5300,467.7100,47926,1648
RSI,49527,227,24.0100,100,23.9900,24.0100,47027,2500
UNM,49512,111,25.6800,200,25.6700,25.6800,47089,2423
EFG,49388,200,103.3200,1,103.3100,103.3000,48634,754
FTEK,49326,2400,5.7200,281,5.6600,5.6600,46454,2872
WPC,49217,100,66.7700,120,66.7400,66.7400,48789,428
VIR,49116,100,43.2500,100,43.0900,43.1600,48019,1097
U,49033,27,147.5400,3,146.8200,146.8800,48242,791
EWS,49003,5700,22.7300,2700,22.7200,22.7200,47794,1209
UDOW,48969,100,108.9900,100,108.9500,108.9400,48211,758
OTEX,48922,301,47.1000,121,47.0700,47.0800,47619,1303
EOLS,48812,1300,5.8700,300,5.8300,5.8600,48512,300
ESPR,48621,143,25.6200,100,25.5100,25.5600,48495,126
CNYA,48593,200,45.8600,1000,45.7200,45.7500,45593,3000
GAU,48372,600,1.2200,850,1.2100,1.2200,41572,6800
CLDX,48318,100,17.9100,100,17.8700,17.9100,47973,345
AER,48231,100,42.4800,154,42.3800,42.2500,47390,841
ENLC,48131,1600,3.8600,800,3.8500,3.8500,47766,365
IFRA,48111,60,31.1200,1000,31.1100,31.1200,48111,0
LMBS,48092,900,51.4600,1100,51.4500,51.4700,47692,400
TEL,48012,100,130.8700,39,130.7900,130.8300,47461,551
STPK,47887,200,33.7000,100,33.3400,33.5900,45564,2323
NVT,47862,100,23.7300,200,23.7200,23.7300,46558,1304
KTOS,47772,3,29.6500,1,29.6000,29.6200,45533,2239
ONCY,47760,1700,2.8000,2300,2.7800,2.7850,47360,400
IRBT,47646,300,98.8600,400,98.4100,98.4400,47439,207
SIG,47610,300,35.9700,85,35.6700,35.7900,47610,0
ATCO,47585,403,10.9800,108,10.9700,10.9700,47585,0
LGF.B,47577,200,11.7800,304,11.7700,11.7900,47577,0
FVD,47519,2800,35.6400,1500,35.6300,35.6200,42235,5284
LULU,47502,97,349.2300,8,349.0800,349.1150,46918,584
SYRS,47493,100,12.2700,104,12.1700,12.2300,47267,226
BIG,47206,100,49.4400,200,49.2700,49.3100,44589,2617
GERN,47182,5834,1.6800,3830,1.6700,1.6750,46487,695
PEB,47172,8,20.9300,100,20.8700,20.8500,43110,4062
OTIS,47154,100,63.8100,100,63.7700,63.7900,46173,981
BOX,47145,100,17.8000,300,17.7900,17.8000,45914,1231
EWQ,47113,2400,33.6800,1800,33.6700,33.6600,46199,914
EPI,46993,100,30.3500,2000,30.3400,30.3500,44093,2900
VKTX,46992,1035,6.8600,300,6.8500,6.8600,46892,100
ZNTEU,46967,100,14.0000,100,13.8700,13.9600,45471,1496
PAYX,46916,59,87.7300,452,87.6700,87.6800,45464,1452
ONEM,46692,85,49.0200,1,49.0000,49.0100,45968,724
TRX,46692,1000,0.6425,500,0.6310,0.6400,17407,29285
BHTG,46677,1530,1.7500,1400,1.7400,1.7450,45477,1200
NUE,46622,100,54.5500,100,54.5100,54.5100,45953,669
ALKS,46597,108,21.6400,2,21.6100,21.6300,45027,1570
BNDX,46597,4400,58.2000,1120,58.1900,58.1950,42388,4209
HDB,46525,668,73.3200,63,73.2400,73.3100,45930,595
SJR,46428,2600,17.7800,200,17.7700,17.7700,45967,461
GLDM,46411,48800,18.6100,55400,18.6000,18.6050,45911,500
HOG,46389,200,42.0100,100,41.9800,42.0000,45059,1330
WCN,46383,100,103.1300,100,103.0600,103.1000,46312,71
CME,46366,10,186.3200,1,186.2300,186.3400,45567,799
LYG,46265,50200,1.9000,80914,1.8900,1.8950,45764,501
CLOU,46240,1900,28.5400,1300,28.5100,28.5400,44585,1655
ILTB,46210,300,74.2600,300,74.0900,74.1550,46210,0
GSM,46017,368,2.2200,1300,2.2100,2.2200,45107,910
PAGS,45948,100,57.5000,45,57.3000,57.4900,44203,1745
DE,45938,100,305.7400,5,305.5100,305.5900,44430,1508
MDGS,45905,200,2.7500,800,2.7300,2.7500,45281,624
ANTM,45847,23,322.1900,3,321.8700,322.0400,45184,663
PNC,45844,104,154.0400,151,153.9500,154.0300,44218,1626
CEF,45744,200,18.8400,300,18.8300,18.8400,42718,3026
NVAX,45731,1,125.4300,100,125.0500,125.3600,44116,1615
APXT,45683,2,15.5600,300,15.5100,15.5000,42677,3006
HZNP,45678,8,78.2800,2,78.0000,78.0300,43064,2614
TLSA,45555,100,4.3800,200,4.3200,4.3200,45555,0
IXUS,45296,100,70.5500,3400,70.5400,70.5500,44380,916
EBON,45190,100,5.1700,100,5.1200,5.2100,42051,3139
YRCW,45154,1001,5.3900,500,5.3800,5.3900,44229,925
IZRL,45140,100,32.9200,194,32.9100,32.9200,44988,152
ARKF,45120,500,54.1400,401,54.0800,54.1200,33295,11825
BPYU,45053,200,17.1200,100,17.1100,17.1050,39448,5605
TGI,45026,300,12.2100,900,12.1800,12.2000,44482,544
HOPE,44949,330,12.2900,300,12.2800,12.2900,42599,2350
CPST,44873,200,12.2200,100,12.0300,12.1050,44873,0
BDSI,44691,500,4.2700,900,4.2600,4.2600,38991,5700
LGF.A,44673,496,12.9900,538,12.9700,12.9700,40002,4671
ASML,44636,200,569.3600,1,568.5000,569.2600,43799,837
MAR,44625,2,127.2400,100,127.2100,127.2300,42888,1737
OGIG,44614,700,58.7400,125,58.7000,58.7300,44614,0
KALA,44541,102,7.4600,100,7.4500,7.4500,42743,1798
HAS,44444,256,97.6900,56,97.5900,97.6300,42458,1986
CPB,44375,100,46.4300,200,46.4000,46.4100,43424,951
LIN,44339,5,254.3300,2,254.3000,254.3300,43844,495
MPLX,44315,500,23.5600,100,23.5500,23.5600,41154,3161
SDPI,44276,1900,0.9389,1900,0.8985,0.9194,36651,7625
CDXS,44199,200,25.7600,101,25.6700,25.8200,42317,1882
EW,44172,61,87.4800,100,87.4300,87.4400,43853,319
CKPT,44146,100,3.8300,58,3.8100,3.8100,40540,3606
TGTX,44085,100,47.7400,100,47.5900,47.6400,43885,200
MRUS,44056,100,26.4900,100,26.3900,26.5600,41762,2294
PHR,44053,4,70.0300,200,69.7800,69.9500,42643,1410
HFC,43968,100,28.5700,5,28.5600,28.5800,43958,10
ATRS,43914,1200,4.3100,400,4.3000,4.3000,43514,400
TTWO,43896,3,205.5700,100,205.4400,205.4700,43141,755
AMPE,43848,4182,1.5600,700,1.5500,1.5500,43452,396
AHPI,43821,100,7.0700,100,6.9800,6.9200,43356,465
NR,43799,2200,2.6800,201,2.6500,2.6400,43399,400
DOGZ,43791,100,2.0700,100,2.0600,2.0700,43265,526
DMYD,43775,200,19.8400,100,19.7000,19.7600,43225,550
AHCO,43752,4,38.1800,101,38.1300,38.1500,43544,208
ECH,43683,300,32.6000,10,32.5800,32.5900,43629,54
AMBA,43648,42,110.1800,350,109.7700,109.8100,42884,764
WW,43610,300,25.1000,300,25.0500,25.0600,41950,1660
AOD,43606,200,9.1500,100,9.1400,9.1600,43606,0
CLII=,43538,102,14.7500,400,14.6000,14.7500,43538,0
NFE,43487,200,47.3100,1,47.1400,47.1900,41988,1499
ESI,43462,500,17.7400,3,17.7300,17.7400,39959,3503
LC,43307,100,11.5400,500,11.5200,11.5400,42356,951
VCEL,43211,64,40.2500,300,40.0100,40.0800,43151,60
HEFA,43166,3500,31.5300,6100,31.5200,31.5200,43166,0
SMTS,43155,209,3.7000,800,3.6900,3.7000,34287,8868
MRKR,43139,1700,2.0600,900,2.0300,2.0400,22460,20679
QDEL,43083,4,218.3300,100,217.1800,218.5400,42323,760
TWLO,42921,125,390.5800,100,387.9100,389.0000,42509,412
JBHT,42902,100,147.0500,100,146.9700,147.0300,42010,892
AYRO,42901,100,7.0500,20,7.0000,7.0200,42149,752
LB,42820,200,46.3200,100,46.2400,46.3000,41154,1666
RHI,42761,382,68.1400,100,68.0400,68.0900,42457,304
CE,42685,5,132.5000,100,132.3600,132.4600,42414,271
TINV+,42657,200,1.9700,100,1.8600,1.9500,42657,0
APWC,42637,100,4.4400,100,4.3300,4.4500,42237,400
AI,42634,100,130.1000,1,129.6200,129.4800,40710,1924
GNTX,42631,1,36.6000,215,36.5800,36.5800,38020,4611
GPK,42621,308,17.4200,900,17.4100,17.4000,40999,1622
SIOX,42603,100,2.8700,200,2.8600,2.8600,30032,12571
CIBR,42578,400,45.5500,1100,45.4900,45.5300,40573,2005
BGCP,42563,1307,3.8200,3520,3.8100,3.8200,41917,646
CEQP,42500,500,19.5400,100,19.4900,19.5400,41614,886
DCP,42419,100,20.8300,100,20.7300,20.8200,41898,521
VLRS,42417,900,11.2500,600,11.2400,11.2400,42357,60
PSTH,42266,100,29.2300,200,29.1100,29.2300,39356,2910
ICLK,42261,200,13.1400,500,13.1200,13.1300,39961,2300
REGI,42247,27,97.1300,100,96.7300,96.8100,42029,218
RMO,42103,100,19.7500,5,19.6200,19.6800,40188,1915
CWEN,41967,2,35.2600,200,35.2300,35.2300,41311,656
TROX,41918,200,16.4600,100,16.4400,16.4500,41247,671
CRMD,41836,300,8.7300,100,8.6200,8.6500,41115,721
USA,41812,1100,7.2500,2800,7.2400,7.2400,39912,1900
RLGY,41811,415,16.4900,400,16.4500,16.4650,41252,559
ARI,41707,300,11.7100,600,11.6900,11.7000,39575,2132
ARR,41704,300,11.2400,600,11.2300,11.2300,39093,2611
ROOT,41612,173,17.5700,200,17.5200,17.5000,40892,720
RCM,41582,103,26.1400,1,26.0800,26.1000,41310,272
EGHT,41581,8,36.9600,80,36.9300,36.9300,41277,304
RES,41508,500,3.6800,1300,3.6700,3.6800,39994,1514
BEEM,41435,100,65.7600,300,65.0300,65.0600,40648,787
WTER,41417,3000,1.1400,1900,1.1300,1.1350,40367,1050
ACWV,41379,1000,97.7700,200,97.7200,97.7300,27392,13987
VXUS,41293,6600,63.1700,7700,63.1500,63.1500,39055,2238
STRR,41204,100,3.8900,100,3.8000,3.8600,40804,400
TGC,41171,125,1.6500,200,1.6000,1.6100,28673,12498
IRIX,41148,1300,5.5000,100,5.3700,5.2800,40948,200
KIRK,41136,100,24.8100,100,24.6100,24.7600,40526,610
OXLC,41103,200,6.2000,700,6.1700,6.1800,39458,1645
ACN,41049,100,258.2000,200,258.1500,258.1800,39145,1904
PFSI,41032,100,61.4400,80,61.3000,61.3400,40922,110
GOGO,40977,100,11.8400,100,11.7500,11.7900,39462,1515
IEO,40958,1300,40.1700,1502,40.1400,40.1500,40258,700
SKX,40870,100,36.7700,39,36.7500,36.7600,40774,96
HP,40864,100,24.6300,193,24.5900,24.6100,40563,301
TPGY,40837,400,25.4600,100,25.3500,25.4200,35953,4884
LPSN,40833,100,64.2800,5,64.1800,64.1700,40618,215
NEAR,40826,20858,50.2500,5243,50.2400,50.2450,38476,2350
DAR,40789,100,67.9200,12,67.8900,67.8900,40361,428
VIAV,40756,1510,16.1700,1832,16.1600,16.1600,40001,755
TYME,40715,100,1.8700,300,1.8600,1.8600,40715,0
TTD,40704,200,820.1900,12,817.0000,817.9100,40465,239
ANF,40660,100,24.3100,100,24.2700,24.3000,40030,630
HCDI,40626,200,3.2700,100,3.2300,3.2100,40326,300
GOL,40583,1100,8.5000,400,8.4900,8.4900,39715,868
PXS,40573,100,1.1100,100,1.0800,1.0900,32038,8535
AMWL,40532,10,29.0900,10,29.0500,29.1200,39281,1251
IQLT,40506,1600,36.6700,200,36.6600,36.6600,39006,1500
BKD,40426,800,4.6000,700,4.5900,4.6000,39926,500
SCZ,40337,1000,70.4900,900,70.4800,70.4800,38411,1926
UWM,40329,610,105.7700,500,105.7300,105.7200,35354,4975
DBD,40299,3,12.9900,241,12.9600,12.9400,39573,726
MTCH,40217,100,145.0700,167,144.5600,144.6100,39261,956
SYY,40192,63,77.0700,200,77.0300,77.0300,39746,446
UNFI,40163,58,24.3300,4,24.2300,24.2400,39265,898
CCC,40095,200,29.1900,100,29.1700,29.1800,39675,420
SYK,39893,1,243.6700,36,243.4900,243.5100,38852,1041
OVID,39871,700,2.5800,1000,2.5700,2.5700,39416,455
LADR,39825,502,10.4300,500,10.4100,10.4200,38425,1400
EMKR,39796,1000,4.6600,100,4.6100,4.6200,38678,1118
TEF,39759,10065,4.5400,7185,4.5300,4.5350,39759,0
ANH,39758,2200,2.6400,3581,2.6200,2.6300,39658,100
REET,39717,900,23.9900,900,23.9800,23.9900,39312,405
PUBM,39665,100,37.8700,100,37.4500,37.8400,33771,5894
VNO,39556,100,37.6500,9,37.6200,37.6300,39135,421
PLD,39536,22,100.1000,1,100.0700,100.0600,38706,830
FUSE,39447,100,12.1700,100,12.1000,12.1100,33894,5553
EVGN,39317,100,6.1900,200,6.1300,6.1600,39065,252
MMC,39291,100,112.4200,4,112.3800,112.3800,37656,1635
IGE,39258,100,25.1700,3400,25.1600,25.1600,38958,300
MRSN,39238,100,19.8800,100,19.7900,19.8300,39136,102
TGH,39229,300,20.3000,201,20.1800,20.1800,21098,18131
GDRX,39227,200,42.8100,100,42.6000,42.5550,38259,968
USFD,39185,100,35.6100,69,35.5100,35.5900,38958,227
PRVB,39169,700,14.2500,100,14.1800,14.1500,35943,3226
CMA,39085,100,62.8200,86,62.7400,62.7600,38942,143
STNG,39058,200,12.6100,24,12.6000,12.6000,37135,1923
RPAI,38875,200,9.2100,500,9.2000,9.2000,37974,901
DRIV,38868,2000,27.8700,80,27.8500,27.8500,37709,1159
SEAS,38863,101,30.0400,100,29.9100,30.0300,38272,591
FI,38851,1500,2.8000,326,2.7900,2.8000,37751,1100
SRAC,38799,100,24.2900,100,24.2400,24.2300,38197,602
BTWN,38734,200,15.0500,300,15.0000,15.0000,36387,2347
ALK,38720,4,55.0200,196,54.9700,55.0200,36837,1883
SAIL,38616,100,57.1900,200,57.1200,57.1500,37756,860
AGO,38595,300,36.6500,100,36.5300,36.5400,38113,482
SATS,38536,99,23.7500,350,23.7400,23.7500,37649,887
ALB,38424,100,176.0400,1,175.8400,175.9800,37568,856
EHTH,38414,100,80.9800,100,80.7300,80.7900,38174,240
QTNT,38354,500,6.0100,489,5.9900,5.9900,35980,2374
HOLX,38350,100,75.9100,113,75.8800,75.8900,37901,449
LTRPA,38346,600,4.4800,600,4.4600,4.4700,35546,2800
APPN,38336,10,182.7200,100,181.8600,182.8900,36653,1683
AACQ,38293,120,11.0000,200,10.9800,10.9900,35916,2377
AGEN,38258,1184,3.4500,902,3.4400,3.4500,36960,1298
SURF,38215,100,13.5600,800,13.4500,13.5100,37386,829
GES,38073,209,24.0000,66,23.9500,24.0000,38071,2
SQM,37951,200,57.1800,400,57.1500,57.1800,36389,1562
ORGO,37882,100,10.2100,200,10.1200,10.1600,36913,969
PTGX,37881,63,23.5800,100,23.4100,23.5200,37770,111
IRM,37803,100,30.2500,400,30.2400,30.2400,34242,3561
ELP,37781,1100,12.4000,1200,12.3800,12.4000,36261,1520
SNDX,37711,400,21.7000,100,21.5000,21.6100,37660,51
EXPCW,37670,200,3.9400,100,3.8900,4.0000,35940,1730
NCR,37669,300,33.9700,68,33.9500,33.9600,37182,487
TRST,37396,800,7.1800,200,7.1600,7.1700,36551,845
IHRT,37377,100,13.7400,100,13.7200,13.7300,37224,153
MDRX,37315,297,16.7000,200,16.6900,16.7000,36514,801
CERC,37273,400,3.0600,800,3.0400,3.0400,36073,1200
HTOO,37271,100,22.1400,200,21.9200,22.0000,35275,1996
VUG,37244,650,260.4800,100,260.4300,260.3500,37040,204
VER,37207,400,35.9900,100,35.9700,35.9900,33221,3986
ILMN,37185,14,405.9600,38,405.4900,405.8300,36199,986
WBT,37143,100,13.9200,900,13.8900,13.8700,36873,270
AEE,37087,100,72.1400,203,72.0800,72.0900,36534,553
EURN,37082,700,8.3100,1515,8.3000,8.3000,36682,400
NERV,37065,902,3.3300,700,3.3200,3.3300,36965,100
KYN,37058,900,6.7100,1100,6.7000,6.7050,34643,2415
FRO,37053,881,6.2000,300,6.1900,6.1900,35690,1363
SIVR,37022,2000,25.0800,2700,25.0700,25.0900,36120,902
SPEM,37007,300,45.5800,1200,45.5700,45.5700,34106,2901
NMRK,36825,200,7.2200,1000,7.2000,7.2050,34245,2580
ZTS,36779,101,164.6400,93,164.5700,164.5500,34875,1904
MMP,36770,200,46.4000,100,46.2100,46.4400,36727,43
VHC,36714,100,5.3700,400,5.3400,5.3600,35734,980
ULTA,36617,1,300.7800,1,300.5900,300.6800,36283,334
UDR,36569,100,39.4200,300,39.4000,39.4100,36241,328
AQN,36554,500,17.3500,1006,17.3400,17.3400,35482,1072
TENX,36485,100,2.6400,100,2.5900,2.6100,35385,1100
SLCA,36472,100,8.7900,100,8.7800,8.7700,31866,4606
EXAS,36450,100,148.8400,100,147.5600,148.2050,35613,837
MELI,36309,4,1946.7200,4,1941.0900,1942.6300,35455,854
AGIO,36261,62,47.9400,100,47.4400,47.6800,36161,100
CHMA,36252,300,4.2400,1130,4.2200,4.2300,33228,3024
AVYA,36144,100,22.3100,300,22.2600,22.3000,35843,301
WM,36104,147,114.7400,100,114.6600,114.6800,34653,1451
AON,36096,27,210.8000,13,210.6600,210.6000,34918,1178
VIOT,36088,100,7.4800,100,7.3900,7.4200,35995,93
HQY,35986,20,84.4900,29,84.2000,84.6000,35517,469
NEO,35978,100,56.0800,100,56.0300,56.0300,35715,263
SPTL,35977,3300,43.3300,5650,43.3200,43.3200,29077,6900
OKTA,35902,100,262.4700,10,262.0000,262.1500,35560,342
WDR,35810,9553,25.1300,339,25.1200,25.1200,34693,1117
VDE,35803,1000,58.3600,100,58.3400,58.3500,35502,301
SSYS,35769,60,36.6300,100,36.5100,36.5800,33802,1967
SPCB,35710,2700,1.2900,3000,1.2800,1.2800,35709,1
CEL,35655,100,4.4500,500,4.4000,4.4000,35555,100
TSEM,35614,200,30.6000,200,30.4000,30.6000,31114,4500
CG,35559,100,34.2700,100,34.2300,34.2500,35387,172
ICSH,35557,5076,50.5400,16369,50.5300,50.5400,35221,336
SIL,35509,100,43.0500,72,42.9400,43.0800,29559,5950
ITA,35498,500,94.1300,100,94.0900,94.0900,35091,407
KERN,35445,1800,5.7600,100,5.7100,5.7300,33333,2112
ABIO,35430,57,4.6900,200,4.6600,4.6800,28110,7320
PGF,35390,1800,18.9000,2100,18.8900,18.8900,31061,4329
IWD,35321,100,141.2700,670,141.2600,141.2600,32242,3079
TALO,35291,200,9.9300,100,9.9200,9.9200,34778,513
BSJN,35267,1900,25.3400,800,25.3300,25.3400,34067,1200
GTES,35255,100,14.5400,301,14.4700,14.4800,35255,0
YUMC,35252,400,59.4100,8,59.3500,59.3500,35044,208
PPR,35204,602,4.5200,773,4.5100,4.5150,30304,4900
NOW,35162,16,546.1600,14,545.8200,546.1500,34323,839
RLJ,35161,200,14.3000,100,14.2800,14.3000,34039,1122
HR,35094,100,31.1400,100,31.1300,31.1300,34972,122
NOBL,35070,1300,81.0400,400,81.0200,81.0300,34757,313
CMCM,35060,1800,2.4100,1900,2.3700,2.4100,34680,380
SHAK,34989,200,109.1800,102,108.9900,109.0800,34385,604
UPWK,34983,7,40.3300,100,40.2700,40.3000,33517,1466
REGN,34950,10,533.8100,10,533.0800,533.4100,33806,1144
NS,34860,100,15.8300,100,15.7400,15.7050,30850,4010
BOOT,34830,100,57.9100,2,57.8300,57.8700,34560,270
FBC,34800,100,47.2300,100,47.0500,47.0400,34235,565
IGF,34776,800,44.3300,401,44.2900,44.2700,34145,631
TRUE,34742,700,4.8400,700,4.8300,4.8400,34742,0
CVM,34719,100,14.4400,100,14.3100,14.5000,32125,2594
NVST,34692,85,36.5500,300,36.4100,36.3700,34582,110
IAA,34672,100,61.0800,100,60.8200,60.8500,31654,3018
FSRVW,34627,100,5.4100,100,5.2900,5.2900,31847,2780
MTB,34596,1,145.8600,37,145.7100,145.9200,34185,411
RAVE,34591,3400,1.1300,900,1.0900,1.1000,34091,500
RYAM,34585,1500,7.4800,700,7.4400,7.4400,34382,203
GPN,34543,100,190.0900,29,189.9700,190.0200,34057,486
TWST,34521,100,194.3100,1,193.6900,194.8700,34206,315
UPST,34503,100,63.9900,100,63.5000,63.4000,33095,1408
VSH,34452,100,23.1800,400,23.1700,23.1800,31739,2713
HWC,34427,5,38.0000,100,37.8800,37.9600,33851,576
RODM,34414,600,29.0800,5100,29.0700,29.0800,32614,1800
BBIO,34395,100,66.2600,225,66.1700,66.1900,33566,829
LQDA,34364,100,2.9700,600,2.9600,2.9700,33832,532
MDLY,34349,100,10.7800,100,10.5600,10.6300,26672,7677
APM,34271,100,3.5000,100,3.4200,3.4600,32641,1630
XONE,34252,100,22.0600,200,21.8700,21.9000,33591,661
MRVI,34223,108,30.3500,77,30.1000,30.2600,27561,6662
INN,34219,592,8.7100,1844,8.7000,8.7050,33644,575
IEA,34201,66,22.8800,18,22.7600,22.8000,34021,180
SILV,34163,100,9.4200,100,9.3900,9.4100,32006,2157
GCI,34116,200,4.0200,1900,4.0100,4.0200,33514,602
LNG,34105,100,66.6800,100,66.6300,66.6400,32312,1793
TDC,34087,300,25.8600,682,25.8500,25.8600,33876,211
UPLD,34079,101,49.0600,100,49.0200,49.0400,33908,171
CBAY,34069,200,5.7400,190,5.7300,5.7300,32878,1191
CVNA,33998,1,274.3700,200,274.0700,274.3500,30763,3235
NOG,33946,100,10.9000,100,10.8600,10.8900,33504,442
BWEN,33945,100,10.7300,1100,10.6500,10.7200,33511,434
TBF,33940,13350,16.4000,18800,16.3900,16.3850,19530,14410
ISEE,33912,61,5.3900,52,5.3700,5.3900,33423,489
GRUB,33905,100,78.1300,41,77.7600,77.8500,30590,3315
JOB,33896,900,1.3100,100,1.3000,1.3000,33796,100
NVO,33882,16,72.5500,100,72.5000,72.5300,32837,1045
OCSL,33843,700,5.8100,505,5.8000,5.8000,33843,0
EQR,33804,100,61.8300,200,61.8100,61.8100,33428,376
DBEF,33772,3800,34.7500,2300,34.7400,34.7500,33567,205
SHOP,33755,1,1201.0000,1,1198.0000,1200.7500,32685,1070
PRMW,33754,300,16.1300,400,16.1200,16.1300,33542,212
CDNS,33743,96,138.7900,100,138.6900,138.7900,32840,903
BVN,33738,95,10.7000,100,10.6500,10.6800,32302,1436
QRVO,33724,2,183.8200,5,183.6300,183.6900,33043,681
DEN,33703,100,29.3600,200,28.9100,29.1000,33531,172
WSM,33636,300,128.0300,45,127.1800,127.5900,32179,1457
BILL,33509,249,130.5000,100,130.4100,130.4550,33247,262
TXRH,33494,100,78.8700,100,78.5300,78.5600,30864,2630
APG,33439,415,18.6300,300,18.5400,18.5800,33316,123
ENIA,33397,200,7.9200,500,7.9100,7.9200,32826,571
IDRA,33394,100,5.9700,100,5.9300,5.9500,33073,321
ICE,33393,100,112.8700,100,112.8300,112.8400,32702,691
BIMI,33387,100,2.0200,450,1.9400,1.9800,27949,5438
MSTR,33358,118,532.0200,100,529.5900,529.9700,31211,2147
VEDL,33297,200,9.3000,194,9.2900,9.2900,29761,3536
TRQ,33284,100,11.5900,100,11.5700,11.5900,31584,1700
L,33261,101,46.8400,10,46.8100,46.8400,33226,35
SVC,33255,100,11.1300,200,11.0700,11.1100,31910,1345
ESGV,33254,500,72.5400,600,72.5100,72.5100,30788,2466
IUSB,33240,2027,54.2600,600,54.2400,54.2550,33240,0
APD,33214,100,283.7700,100,283.4700,283.6600,32388,826
MAXN,33213,100,47.9500,200,47.5900,47.6600,32788,425
GBIO,33195,119,31.1800,100,31.0200,31.0800,32948,247
CUK,33193,200,17.9600,647,17.9100,17.9200,32558,635
TRIP,33150,6,33.6800,300,33.6500,33.6400,32810,340
AMRX,33128,301,4.8800,700,4.8700,4.8700,31697,1431
DDS,33042,100,78.1400,100,77.2400,77.6300,32756,286
PHYS,32967,1470,14.7000,3700,14.6900,14.7000,32967,0
SRPT,32922,35,97.5700,100,96.7300,97.1400,31226,1696
EOSE,32848,27,25.4000,200,25.1900,25.2500,31077,1771
WETF,32833,200,5.3300,600,5.3200,5.3200,31520,1313
MNSO,32808,100,30.2200,100,30.1000,30.1500,24027,8781
PSO,32746,800,9.8300,1900,9.8200,9.8200,30565,2181
AJAX,32745,400,12.1200,5,12.1000,12.1100,24073,8672
GMDA,32711,100,9.0400,100,8.9100,8.9800,25746,6965
NEP,32683,100,84.6600,100,84.3100,84.2200,32190,493
BG,32675,100,68.7500,100,68.7100,68.7400,32675,0
PS,32651,113,21.4700,522,21.4500,21.4650,31827,824
CMC,32629,2,21.0900,21,21.0700,21.0800,32616,13
DES,32602,1300,28.0700,600,28.0500,28.0500,30302,2300
EARS,32557,200,2.8500,200,2.7900,2.7900,31427,1130
AXNX,32548,30,53.7400,10,53.6200,53.6800,32367,181
WNS,32537,100,71.9000,70,71.4700,71.6500,32273,264
SELB,32497,800,3.4100,400,3.4000,3.4100,32497,0
CPRT,32492,4,116.0800,100,115.9800,116.0300,32067,425
CRSA,32438,200,10.8100,100,10.6700,10.7300,29628,2810
CREX,32295,200,1.8300,2100,1.7700,1.8100,30862,1433
EGY,32281,800,2.3200,800,2.2700,2.2900,30270,2011
PCTI,32281,100,9.1500,400,9.0900,9.1500,31943,338
ACLS,32280,15,39.7700,2,39.6900,39.7200,31799,481
ECL,32256,110,214.5300,2,214.4500,214.4900,18754,13502
SNE,32204,100,102.4500,102,102.3100,102.3100,31604,600
SLVP,32200,600,16.0100,182,15.9600,16.0000,32200,0
HAPP,32153,200,2.0200,1200,2.0000,2.0200,31853,300
ENTG,32131,18,113.3400,100,112.8900,113.2600,32033,98
BMRN,32107,19,86.8300,4,86.7700,86.8100,31704,403
ARDX,32078,103,7.1300,100,7.0900,7.1200,30871,1207
NMIH,32050,100,23.4000,100,23.3800,23.3900,31767,283
BKCC,32045,400,2.9400,108,2.9300,2.9300,28699,3346
RRR,32034,100,26.0500,100,26.0000,26.0200,32034,0
ALL,32028,100,111.1500,49,111.0800,111.1200,31973,55
RPAY,32021,100,24.5300,200,24.4900,24.5200,32021,0
IGLB,32019,400,71.2000,100,71.1900,71.1800,29919,2100
EIX,31999,100,59.6600,200,59.5700,59.5800,31605,394
LYV,31951,100,74.3600,53,74.3100,74.3300,31292,659
AFRM,31947,500,108.0000,203,107.1900,107.8900,27992,3955
OTIC,31888,100,4.7600,200,4.7200,4.6900,31423,465
LAIX,31884,300,1.7000,400,1.6400,1.6800,31884,0
SPMB,31878,2110,26.4200,1400,26.4100,26.4300,7503,24375
SILJ,31875,700,14.8700,100,14.8100,14.8500,31875,0
STZ,31864,10,228.5600,58,228.5100,228.5400,30916,948
BBVA,31859,13100,4.9000,14404,4.8900,4.8950,31249,610
MYT,31856,100,2.2300,100,2.1900,2.2200,31856,0
MBB,31800,2200,110.2200,221,110.2100,110.2100,31656,144
WBS,31747,100,49.5300,100,49.2900,49.5300,31358,389
CWBR,31733,1300,1.6900,600,1.6400,1.6550,31031,702
PLAY,31618,3,33.8900,200,33.8400,33.8600,28504,3114
SPLK,31585,100,173.2400,29,172.5900,173.0600,31378,207
PSEC,31535,4142,6.1400,2196,6.1300,6.1350,31335,200
GPRE,31524,100,18.8500,49,18.7900,18.8300,30841,683
THCB,31520,100,14.9300,1,14.8500,14.9000,27623,3897
BLL,31514,7,91.7200,105,91.6600,91.7200,31296,218
ARNC,31474,400,29.0800,100,28.9900,28.9800,31244,230
BTRS,31420,100,17.6700,100,17.6300,17.6300,31120,300
PLNT,31339,100,81.4600,3,81.3800,81.4200,31114,225
LPLA,31319,200,117.2600,41,117.1200,117.2300,30694,625
ACWX,31308,1700,55.7200,600,55.7100,55.7100,28495,2813
FLGT,31290,100,66.9200,100,66.3000,66.5500,31185,105
TTCF,31279,700,24.1900,200,24.0700,24.0800,30798,481
GAN,31167,64,23.8100,100,23.6600,23.6900,30679,488
XERS,31161,1500,5.3200,2,5.3000,5.3100,31061,100
BXMT,31004,1,27.2700,100,27.1900,27.1900,28877,2127
WMG,30910,300,39.0500,100,38.8900,39.0500,30910,0
DGNR+,30875,100,4.4300,100,4.3100,4.5000,30775,100
ROST,30853,45,115.8100,20,115.7200,115.7400,30299,554
MGLN,30803,200,94.5700,1,94.5500,94.5700,30130,673
WAB,30791,100,81.4800,300,81.3900,81.4300,29845,946
HDSN,30764,100,1.2000,100,1.1900,1.2000,26794,3970
MOAT,30739,600,64.5300,300,64.5100,64.4900,30638,101
OSUR,30730,111,13.5100,540,13.4800,13.4900,30007,723
SWK,30725,28,177.9400,101,177.8100,177.8400,30051,674
GORO,30678,602,2.7500,629,2.7400,2.7400,30409,269
TILE,30652,100,11.0800,102,11.0700,11.0700,30652,0
CELH,30636,100,64.3300,200,64.1800,64.2800,30510,126
FTXR,30569,4000,30.7400,700,30.7200,30.7200,30306,263
GGN,30553,2000,3.5400,1500,3.5300,3.5350,26217,4336
IGSB,30520,1400,55.1200,3000,55.1100,55.1100,29620,900
GPMT,30492,304,10.0100,500,9.9800,9.9900,30454,38
NKTR,30491,101,16.7200,200,16.7000,16.7200,30270,221
PETS,30459,200,30.2800,200,30.1500,30.1400,30259,200
SFTW,30441,200,11.2500,100,11.1500,11.2000,21185,9256
PLG,30396,300,4.2800,250,4.2500,4.2800,27046,3350
NUMV,30376,400,31.6600,800,31.6300,31.6700,28976,1400
CLCT,30360,200,91.6600,2600,91.6300,91.6500,30173,187
ACER,30348,100,3.8200,100,3.7000,3.7900,30248,100
NPTN,30298,200,12.3400,100,12.3300,12.3300,27189,3109
MNST,30270,46,89.4000,99,89.3400,89.3500,28715,1555
MTNB,30254,3928,1.5900,900,1.5800,1.5850,29954,300
RL,30229,100,107.7500,100,107.7000,107.7300,29739,490
NWBI,30208,300,13.7900,900,13.7800,13.7900,29706,502
SJI,30182,113,21.2100,300,21.1600,21.1600,30167,15
TGA,30136,800,1.1500,100,1.1400,1.1400,29836,300
VLUE,30118,500,94.3100,680,94.2900,94.2900,29609,509
SFL,30056,200,6.6800,1400,6.6700,6.6800,28422,1634
CAKE,30043,17,43.1400,41,43.0500,43.1200,29928,115
FIXD,30012,300,54.3500,500,54.3300,54.3300,29712,300
BBEU,29945,16700,27.0300,4500,27.0200,27.0200,22145,7800
AQST,29944,300,5.7900,100,5.7600,5.7900,29621,323
IMVT,29926,47,41.4200,100,41.1100,41.2300,29623,303
ERY,29913,2100,26.8800,1600,26.8500,26.8400,21813,8100
SAP,29867,29,127.8800,100,127.2700,127.5600,29228,639
OPCH,29824,100,19.5400,100,19.5000,19.5400,29724,100
JFU,29789,300,1.4700,808,1.4600,1.4650,28305,1484
SOGO,29781,600,8.2400,1200,8.2300,8.2400,29781,0
AMSC,29737,38,28.6100,400,28.4300,28.6100,29445,292
AZEK,29674,200,41.0100,200,40.8500,40.8800,29196,478
PLL,29662,100,49.1300,200,48.8000,48.7500,29024,638
ENTX,29654,5,1.7800,500,1.7200,1.7800,29254,400
BYD,29618,100,50.1300,20,50.0000,50.1200,29186,432
SFNC,29607,142,26.2100,200,26.1700,26.2100,29358,249
IWF,29565,300,248.1900,200,248.1500,248.1300,27811,1754
TCF,29556,100,43.2600,100,43.2100,43.2400,29387,169
OGE,29541,200,31.4300,300,31.4100,31.4300,29216,325
LL,29540,69,33.5500,113,33.3900,33.4100,28742,798
ARTL,29510,110,1.0000,500,0.9931,1.0000,26300,3210
OZK,29506,100,34.3400,800,34.3200,34.3300,29015,491
TPX,29506,45,28.8100,200,28.7800,28.8100,27856,1650
SSPKW,29500,100,9.0000,100,8.8400,8.9000,29150,350
ROCH,29473,392,18.7900,100,18.7500,18.7900,28873,600
RVP,29468,200,12.5600,100,12.4900,12.5400,28814,654
ORAN,29466,400,11.6800,900,11.6700,11.6800,28966,500
PRLB,29450,100,190.5800,100,189.4100,189.6100,28594,856
INSM,29419,108,42.5900,100,42.4700,42.5600,29419,0
CLX,29414,17,197.6500,1,197.5000,197.4600,27868,1546
CIT,29402,100,39.8000,200,39.7400,39.7900,28501,901
MOGO,29378,300,4.5400,200,4.5100,4.5300,26844,2534
DYNT,29311,300,1.3200,200,1.3000,1.3100,29067,244
VCLT,29298,113,108.2300,246,108.1500,108.1900,28393,905
ALSN,29293,118,44.1600,4,44.0700,44.1400,29000,293
NSTG,29283,100,76.9000,40,76.4700,76.6200,28682,601
SAVA,29266,100,12.1900,200,12.1100,12.1300,28773,493
HTHT,29222,59,48.2400,200,48.0400,48.2300,29020,202
NCNO,29217,100,71.1900,100,70.7400,70.8400,29148,69
PSAC,29179,200,11.2000,1000,11.1600,11.2000,26466,2713
CPRX,29129,1700,3.7100,1200,3.7000,3.7000,26672,2457
SPDN,29106,33040,17.9000,28900,17.8900,17.9000,29106,0
ATOM,29102,50,30.7500,100,30.5200,30.6900,27850,1252
CHTR,29102,2,649.9400,21,649.4900,649.7700,28646,456
MCF,29095,1000,3.0100,46,3.0000,3.0000,28595,500
SKY,29095,320,36.2600,100,36.2000,36.2200,28145,950
HPR,29074,100,10.2200,100,10.0600,10.1500,29073,1
DRNA,29045,100,23.1900,103,23.1800,23.1800,28742,303
CNNE,29038,60,42.6200,1,42.4900,42.5000,28938,100
FWONK,29010,100,41.0100,100,40.8500,40.9700,29010,0
CGIX,29000,100,4.4400,300,4.4000,4.4200,27856,1144
AIA,28903,400,99.9200,261,99.7200,99.7450,28901,2
REML,28895,2000,5.7200,402,5.6900,5.7000,24316,4579
VEEV,28859,100,288.6300,100,287.5600,287.9500,27747,1112
SCHC,28839,300,38.7600,300,38.7400,38.7400,28739,100
SUM,28816,100,23.2900,5,23.2700,23.2700,27121,1695
ALNA,28814,300,1.6200,800,1.6100,1.6150,28616,198
NXE,28805,6800,2.8500,4800,2.8300,2.8400,28585,220
MFH,28801,100,3.4200,100,3.2300,3.4000,28601,200
SNSS,28758,200,3.1300,200,3.1000,3.1000,28258,500
FPAC,28716,200,10.4800,100,10.4200,10.4500,24865,3851
MSGN,28715,100,14.5600,200,14.5200,14.5300,27601,1114
NH,28664,2800,3.7600,100,3.7000,3.7150,28664,0
SHY,28650,118520,86.3900,40200,86.3800,86.3850,28650,0
SNCA,28646,200,1.3700,400,1.3500,1.3600,28646,0
FPAC=,28632,200,11.2500,127,11.2000,11.2000,27822,810
FAS,28614,1600,67.6400,500,67.5600,67.6000,26786,1828
SPSB,28542,9080,31.4000,2200,31.3900,31.3950,28542,0
JMST,28514,4179,51.0600,500,51.0500,51.0600,28514,0
TLS,28485,1,39.5300,100,39.1900,39.5600,20803,7682
FALN,28484,300,29.6000,500,29.5800,29.5900,25554,2930
DT,28455,100,46.6100,10,46.5700,46.5650,27735,720
EPZM,28439,8,11.4600,100,11.4500,11.4600,27735,704
RDUS,28427,100,22.0300,100,21.9100,21.9200,28227,200
SBRA,28382,400,17.2400,320,17.2300,17.2300,25696,2686
HALO,28368,100,47.6600,40,47.5500,47.6700,28365,3
PSTI,28350,1500,7.6000,4,7.5200,7.5800,25400,2950
IWR,28343,200,71.5600,100,71.5400,71.5500,27622,721
SOXX,28321,100,422.9500,100,422.7800,422.6600,26092,2229
HUM,28154,13,413.6300,13,413.2000,413.3200,26737,1417
AMCX,28121,138,43.1500,96,43.1000,43.1100,28121,0
SECO,28114,117,2.8800,600,2.8700,2.8800,28114,0
CARA,28090,100,19.1500,100,19.0600,19.1400,27575,515
NWG,28087,4900,4.2700,3300,4.2600,4.2700,27312,775
HCICU,28073,100,12.4200,100,12.2900,12.4100,26490,1583
CZZ,28067,300,18.1600,2,18.1400,18.1500,27867,200
EL,28061,27,256.2000,28,255.9800,256.1000,25470,2591
PSXP,28032,72,28.7500,100,28.5800,28.6000,27451,581
ROIC,27993,200,14.3400,600,14.3200,14.3300,26809,1184
SGOL,27988,27700,17.9600,21500,17.9500,17.9600,27988,0
EXPI,27947,2,97.9100,100,97.4200,97.7600,26969,978
PLM,27930,200,3.9000,100,3.8700,3.9000,27746,184
DMTK,27886,179,43.1300,58,42.7700,43.0250,27450,436
BZUN,27818,300,35.0300,1,34.9200,34.9800,25713,2105
DK,27815,213,20.4200,200,20.3600,20.4000,27715,100
MRIN,27795,3000,2.3400,700,2.3000,2.3100,25998,1797
XSOE,27790,700,43.4800,200,43.4700,43.4700,27590,200
OLN,27785,206,26.2100,5,26.1800,26.2000,27105,680
CINF,27684,155,89.0700,20,88.9600,88.9600,27259,425
ROL,27679,40,37.4900,25,37.4600,37.4700,27267,412
BCLI,27642,282,5.4500,1,5.4300,5.4300,27294,348
CDMO,27621,100,13.6600,100,13.6000,13.6200,27521,100
SLDB,27565,200,6.4700,200,6.4200,6.4400,27551,14
CPSH,27511,8,8.8000,100,8.7500,8.7500,27411,100
HI,27475,10,43.6600,100,43.6200,43.6400,27463,12
ATRA,27444,100,18.4400,500,18.3500,18.3900,27344,100
UGI,27410,101,37.0600,100,36.9800,37.0400,27284,126
JIH,27384,300,12.0700,400,12.0400,12.0500,22180,5204
MEOH,27366,100,37.2100,100,37.1400,37.1800,27066,300
TEN,27366,1,10.7500,100,10.7200,10.7300,26724,642
ISRG,27320,1,798.3700,1,797.5100,797.8900,27057,263
VT,27313,2100,96.3200,1200,96.2800,96.2900,23308,4005
WVE,27310,271,9.7100,96,9.7000,9.7000,27067,243
CCIV=,27303,400,19.2900,900,19.2100,19.1800,27203,100
DLR,27251,2,141.0200,100,140.9500,140.9700,26361,890
RADA,27243,1100,10.4400,100,10.3700,10.3700,22196,5047
PGNY,27213,100,47.7700,2,47.5400,47.5700,27203,10
QTRX,27199,128,80.8100,100,80.1000,80.3400,27162,37
BRKS,27179,20,84.2300,100,84.1800,84.2200,27020,159
ARMK,27168,100,36.2000,307,36.1500,36.1600,27168,0
SNY,27092,11,49.7000,94,49.6200,49.6900,25697,1395
TSCO,27085,20,155.8100,34,155.7200,155.7900,26259,826
NBIX,27079,200,114.6300,127,114.5300,114.6600,26529,550
DNLI,27077,1,75.0500,100,74.6400,75.1300,26850,227
APLS,27065,100,48.6900,100,48.1800,48.4700,26721,344
HIMS,27061,200,15.4900,100,15.4100,15.4700,25494,1567
SNCR,27055,153,5.0200,310,5.0000,5.0000,26635,420
SCS,26947,1,13.4900,713,13.4700,13.4800,26947,0
JE,26905,300,5.5300,600,5.5200,5.5100,25535,1370
SEE,26901,2,45.1900,305,45.1700,45.1300,26735,166
RDFN,26877,100,75.9900,1,75.8000,75.8500,26474,403
APLE,26851,100,13.1100,304,13.1000,13.0900,25493,1358
TTMI,26802,700,14.1800,254,14.1700,14.1700,26583,219
YCBD,26794,600,3.8700,2800,3.8100,3.8300,24571,2223
EVRI,26667,382,13.6400,91,13.6200,13.6250,23892,2775
ORA,26614,1,107.0000,203,106.8200,106.6400,25101,1513
CHD,26581,31,85.0900,400,85.0600,85.0800,23250,3331
TVTY,26575,2,22.0000,100,21.9100,21.9900,25991,584
RPV,26573,100,65.7800,300,65.7700,65.7900,26373,200
CYRN,26555,300,1.3300,144,1.2700,1.2800,24855,1700
CKH,26520,400,41.8100,500,41.7900,41.7900,24920,1600
SBGI,26497,100,31.3600,1,31.3300,31.3400,26294,203
DHY,26492,6226,2.3000,6695,2.2900,2.2950,26490,2
DKS,26475,100,68.0500,37,67.8900,68.0000,21910,4565
LYB,26377,4,93.0700,104,92.9700,93.0400,25561,816
PINC,26340,201,34.5800,100,34.5500,34.5700,25988,352
PGRE,26323,800,9.0200,400,9.0100,9.0200,22776,3547
QCLN,26317,800,85.9200,100,85.8800,85.8800,26145,172
SPT,26315,100,62.8000,138,62.5800,62.7700,25850,465
A,26259,100,127.2900,300,127.2400,127.2400,25393,866
FTK,26253,492,1.8400,5000,1.8300,1.8500,25053,1200
PRTK,26240,100,6.3300,400,6.3200,6.3400,26240,0
KN,26234,100,19.9700,85,19.9500,19.9700,26089,145
LNC,26221,100,51.4300,100,51.3900,51.4100,26014,207
G,26220,15,41.4600,400,41.4500,41.4500,26120,100
OTRK,26198,100,78.4000,100,78.0600,78.0300,25180,1018
ATNF,26182,100,3.5000,100,3.4400,3.4900,25453,729
CLLS,26181,100,31.6300,100,31.3400,31.5300,25557,624
PFFD,26155,700,25.6800,300,25.6600,25.6700,18330,7825
QLTA,26111,200,57.6700,1770,57.6600,57.6700,25799,312
VERO,26090,100,2.3300,300,2.3100,2.3200,25437,653
CSTM,26083,100,13.7000,405,13.6300,13.6400,16745,9338
KFY,26057,99,48.2700,300,48.2500,48.2600,25865,192
GRNQ,26029,100,1.9200,500,1.9100,1.9100,22385,3644
IYW,25974,1100,88.7600,800,88.7200,88.7300,25332,642
CONE,25940,100,71.9700,200,71.8800,71.9050,25763,177
SVFAU,25931,200,13.4700,175,13.3900,13.4000,24675,1256
EXTR,25928,400,7.9300,16,7.9200,7.9100,24195,1733
UFPI,25895,100,59.8300,100,59.7500,59.7700,25793,102
IGIB,25807,816,61.3800,900,61.3700,61.3750,25807,0
IBTB,25800,29200,25.4400,35000,25.4200,25.4400,25800,0
AERI,25747,100,16.4000,38400,16.3900,16.4000,25248,499
BKNG,25729,22,2125.8300,20,2122.0100,2121.8100,25559,170
NTAP,25709,100,65.2400,184,65.1600,65.1900,24682,1027
PPD,25702,3,35.1700,2,35.1200,35.1500,24919,783
MDLA,25701,100,39.7100,100,39.6700,39.6900,25564,137
HYD,25606,300,62.3900,534,62.3800,62.3850,25458,148
WMC,25594,1000,2.9800,386,2.9700,2.9700,25194,400
KRC,25566,100,59.8100,100,59.6100,59.6200,25165,401
IPOD=,25559,400,19.2200,890,19.1300,19.2400,25559,0
APDN,25547,100,10.5800,11,10.4600,10.5100,25514,33
CHKP,25542,5,126.9600,11,126.9000,126.9400,25055,487
YELP,25514,174,31.8000,300,31.7600,31.8350,24395,1119
FMX,25477,100,74.0900,100,73.9900,73.9400,25477,0
APTO,25457,100,4.3500,200,4.3300,4.3300,19040,6417
CVLB,25364,100,10.0700,100,10.0000,10.0000,24114,1250
MAG,25363,100,18.7700,100,18.7300,18.7400,24500,863
MEIP,25358,700,2.9200,300,2.9100,2.9100,25358,0
RGNX,25323,64,43.0200,70,42.8000,42.8200,25092,231
TROW,25307,5,157.3600,100,157.2500,157.4500,25176,131
GRPN,25300,300,33.2600,1,33.1800,33.1900,25297,3
JWS,25261,100,15.9400,100,15.7100,15.8200,22030,3231
ENSV,25221,772,2.0100,453,2.0000,2.0000,15381,9840
TLH,25207,100,153.9100,100,153.8900,153.9000,25056,151
TNAV,25199,1200,4.7600,1750,4.7500,4.7550,25099,100
CMO,25191,453,5.8400,900,5.8300,5.8300,25191,0
INCY,25188,1,94.2700,300,94.2000,94.2200,24695,493
PCRX,25185,2,69.2900,6,69.2100,69.2100,24164,1021
CVET,25173,4,39.4600,100,39.4000,39.4300,24972,201
SKYY,25141,100,99.2100,100,99.1800,99.2100,25141,0
FXR,25106,100,52.3800,200,52.3700,52.4100,25106,0
MICT,25052,1350,2.3500,200,2.3300,2.3350,24952,100
CNO,25030,200,23.5000,100,23.4800,23.4900,24727,303
ALNY,24988,108,166.8600,200,166.6800,166.7700,23592,1396
XPOA,24965,100,10.8100,1,10.7900,10.7900,24850,115
EWP,24964,2100,27.3800,900,27.3700,27.3700,23264,1700
BXP,24947,100,92.0800,12,92.0100,92.0300,24445,502
YEXT,24942,400,17.4700,100,17.4600,17.4700,24942,0
SWETU,24918,200,10.4900,100,10.4200,10.4900,11168,13750
HBM,24900,900,6.8600,6400,6.8500,6.8500,23247,1653
REKR,24888,100,12.6600,100,12.5700,12.6400,24264,624
PMT,24882,100,17.8100,100,17.7500,17.7600,24194,688
AY,24812,36,46.3100,200,46.0600,46.2700,24244,568
BSY,24808,200,45.3700,100,44.7800,45.1300,22418,2390
HGV,24784,46,34.0700,200,33.9100,33.9400,23938,846
WHR,24768,28,196.6500,46,196.2700,196.3600,24139,629
DENN,24763,200,15.7200,138,15.7100,15.7100,24516,247
VSGX,24761,400,62.1800,418,62.1400,62.1500,21658,3103
GD,24729,3,151.5300,133,151.3900,151.5000,23591,1138
CAR,24692,200,42.0900,200,41.9700,41.9800,23700,992
ES,24668,100,87.4400,100,87.3300,87.3800,24142,526
FPRX,24654,100,13.9200,45,13.8300,13.8400,24119,535
GBT,24620,100,47.9100,8,47.8300,47.8800,24386,234
MWA,24603,200,12.3300,500,12.3200,12.3200,23705,898
OIIM,24539,100,10.3900,100,10.3200,10.3700,23939,600
CRTO,24512,100,18.9500,100,18.8200,18.8600,24212,300
GMBTU,24488,100,11.0600,100,10.9900,10.9900,23688,800
NXGN,24488,67,22.1000,600,21.9800,22.0900,24000,488
DCT,24486,10,49.9800,100,49.7400,49.9550,24405,81
AMKR,24480,200,18.4600,300,18.4500,18.4400,22441,2039
ALLO,24453,200,31.2500,286,31.1300,31.1400,24319,134
NLS,24446,206,21.3800,100,21.2700,21.3600,23734,712
IPV,24441,100,16.7100,100,16.6000,16.6200,23933,508
HCC,24423,155,23.2300,100,23.0900,23.1400,24219,204
SCCO,24377,300,70.2000,402,70.1700,70.2000,24301,76
DRRX,24364,1600,2.2400,1200,2.2300,2.2300,23764,600
HRTX,24363,100,17.8100,100,17.7900,17.7900,23960,403
SNPS,24337,5,273.3800,100,273.1600,273.3400,23356,981
CALX,24329,300,34.7600,100,34.6200,34.7200,24041,288
MXIM,24327,56,95.9200,10,95.8600,95.8600,21998,2329
NK,24289,6,17.0900,100,17.0700,17.0800,23754,535
OMER,24274,100,18.6600,100,18.5600,18.6600,23455,819
CLNC,24262,1500,8.5700,107,8.5000,8.5200,24162,100
FNDE,24235,100,30.0400,800,30.0300,30.0500,24135,100
FLWS,24188,100,31.8500,300,31.7600,31.7000,23889,299
ACEV,24181,100,11.4400,188,11.3900,11.3900,22883,1298
SBNY,24176,64,151.6000,100,151.0500,151.4200,24159,17
HA,24167,6,20.6600,102,20.6500,20.6600,23472,695
QGEN,24165,3,53.8400,100,53.7900,53.8600,16328,7837
FTV,24157,1,70.1700,77,70.1100,70.1300,23639,518
HAACW,24147,100,2.9500,100,2.8800,2.9500,24147,0
HAE,24137,100,119.2300,5,119.1600,119.0800,23301,836
ECPG,24032,100,33.0800,100,32.9000,33.0500,24031,1
CHRW,24019,104,98.6100,2,98.5800,98.6200,23702,317
BBGI,24000,300,2.2700,601,2.2300,2.2600,23052,948
CNI,23925,100,108.7400,100,108.6800,108.6900,23365,560
BFI,23894,200,13.5400,100,13.4400,13.5300,23731,163
BNR,23892,100,35.5700,100,35.1600,35.4000,17961,5931
TRVN,23887,3500,2.1700,1400,2.1600,2.1650,23887,0
KMF,23861,46,6.3400,1000,6.3200,6.3300,14356,9505
GLPI,23844,100,41.1200,14,41.1000,41.1000,23232,612
OCUL,23775,2,19.8100,101,19.7200,19.7200,23597,178
PICK,23739,800,39.9300,29,39.9100,39.9100,23629,110
BSJQ,23707,900,25.6300,100,25.6200,25.6200,22285,1422
MCO,23684,7,271.3000,100,271.1300,271.4800,20592,3092
FMBI,23682,100,17.8900,100,17.8800,17.8900,23446,236
OLLI,23665,100,93.2800,100,93.1900,93.2300,23663,2
YSG,23655,100,18.9200,100,18.8200,18.8500,21429,2226
MYOV,23646,100,21.0100,100,20.8200,20.9200,23296,350
SONN,23640,300,2.6800,100,2.6600,2.6700,23040,600
HIW,23639,56,39.9300,28,39.8100,39.8200,23491,148
LPRO,23630,313,37.3500,87,37.2400,37.3800,23530,100
CTXR,23623,1150,1.2600,400,1.2500,1.2550,22524,1099
HYEM,23619,200,23.8700,100,23.6800,23.7800,22719,900
LSPD,23587,100,70.8700,100,70.7500,70.9200,23194,393
CENX,23576,100,11.5000,200,11.4700,11.4800,22689,887
POR,23525,100,41.8400,200,41.7900,41.8300,23525,0
RTP,23468,100,13.7300,200,13.5300,13.6900,23232,236
ZSL,23465,5000,6.8700,15100,6.8500,6.8500,23365,100
LNTH,23436,100,15.4600,1,15.4400,15.4400,23287,149
HSY,23427,22,149.3800,20,149.2200,149.2900,23199,228
AQUA,23424,158,30.4300,200,30.4000,30.4100,23423,1
IIVI,23417,2,93.1500,200,93.0800,93.0800,22589,828
FTSL,23371,1000,48.1200,200,48.0800,48.0900,23257,114
STAY,23297,200,15.5400,100,15.5300,15.5400,22077,1220
REFR,23262,2900,4.5300,100,4.4400,4.5000,23262,0
EWBC,23260,100,61.1700,132,61.1400,61.1400,23067,193
BSJO,23256,900,24.9200,200,24.9100,24.9150,23256,0
ZGNX,23223,81,18.4000,100,18.3800,18.4100,22606,617
DCBO,23203,300,49.2500,100,49.0700,49.0700,23203,0
SAFM,23190,100,139.4100,100,139.0400,139.0800,23026,164
EV,23182,100,71.7800,200,71.7100,71.7500,20376,2806
COHR,23173,9,203.9500,100,203.4400,203.7050,22925,248
SFT,23167,100,8.2600,100,8.2200,8.2200,17298,5869
VMBS,23093,4214,54.0600,1090,54.0500,54.0550,22793,300
FBHS,23088,56,92.4000,56,92.3100,92.3500,22702,386
SIEN,23052,600,4.6300,302,4.6200,4.6300,22710,342
THBR,23044,100,12.9300,180,12.8500,12.8800,21028,2016
SPCX,23042,600,29.5300,100,29.4800,29.4950,16138,6904
SDGR,23033,32,94.7100,100,94.3400,94.3800,21335,1698
PLYA,23026,900,5.8500,299,5.8400,5.8500,21976,1050
GGAL,22995,200,7.6200,300,7.5900,7.5900,22948,47
IBKR,22971,100,68.9800,200,68.9500,68.9600,22964,7
TBX,22966,2300,24.2100,2800,24.2000,24.1950,18300,4666
NPA,22933,100,15.8300,100,15.7300,15.8300,21640,1293
IXC,22920,900,22.4600,1300,22.4400,22.4500,21600,1320
EPR,22843,100,35.8100,158,35.5500,35.7000,21697,1146
LGVW=,22823,1000,24.1500,900,23.7500,24.2500,22623,200
NBLX,22805,200,12.6800,100,12.5800,12.6500,22663,142
BBJP,22801,2000,28.5600,1000,28.5500,28.5500,22501,300
AOS,22791,100,58.2800,100,58.2600,58.2500,21802,989
KSU,22790,2,212.3000,200,212.2100,212.3000,22548,242
CRH,22781,200,44.6000,100,44.4700,44.4800,20570,2211
PAE,22764,1,9.1800,100,9.1300,9.1800,22501,263
HCCCU,22728,100,10.3700,100,10.3100,10.3300,21576,1152
EMPW,22707,200,10.2100,100,10.1900,10.1900,22707,0
IPOD+,22682,100,5.7100,100,5.2800,5.4900,20091,2591
GATO,22667,100,12.8800,400,12.7300,12.8200,22462,205
GSS,22664,200,3.8400,83,3.8300,3.8300,22417,247
STOR,22624,100,31.4600,70,31.3100,31.4150,21120,1504
SSNC,22620,102,67.6200,12,67.5700,67.5900,22599,21
SOXL,22582,139,638.2600,100,637.4800,637.4200,22485,97
FOSL,22536,100,9.4800,200,9.4600,9.4700,20172,2364
ELF,22483,100,23.5000,100,23.4600,23.5000,22027,456
NNN,22420,200,40.1100,100,40.0900,40.1000,22383,37
JNUG,22376,200,105.2400,200,105.0800,105.2100,21045,1331
KLAC,22350,17,303.0000,1,302.6900,302.7400,21782,568
PROG,22348,1600,6.1600,110,6.1200,6.1400,21808,540
FHI,22341,1,30.3800,1,30.3400,30.3500,22238,103
MD,22335,304,24.5600,200,24.5400,24.5400,22259,76
BLUE,22321,100,47.0400,12,46.7600,46.8000,21864,457
TRITW,22307,300,1.7400,100,1.6400,1.6600,21383,924
PING,22279,5,32.1100,100,32.0800,32.1200,20487,1792
SSY,22268,100,1.5200,100,1.4300,1.4700,12926,9342
KOLD,22265,100,47.3200,100,47.2400,47.4500,22165,100
WTFC,22254,10,65.3900,100,65.0200,65.3600,22201,53
WAL,22244,5,69.2900,100,68.9700,69.2700,21951,293
CLSD,22220,2700,3.7200,300,3.6700,3.6800,21380,840
UIS,22214,10,22.9200,41,22.8900,22.8900,21907,307
PRG,22207,100,53.2400,8,53.0900,53.1500,22003,204
CATB,22193,900,2.7100,300,2.7000,2.7100,21061,1132
BEP,22145,100,49.1800,100,49.1100,49.0800,20957,1188
VTVT,22142,300,2.1500,18,2.1400,2.1500,22142,0
WIFI,22140,300,12.2100,100,12.1600,12.1850,22080,60
ALDX,22139,49,11.9000,100,11.8200,11.9000,19839,2300
CARG,22091,100,32.0000,100,31.9300,31.9900,22041,50
WYY,22013,100,13.1500,100,13.0500,13.0000,21788,225
MCHP,22003,6435,151.5000,236,151.3800,151.4300,21200,803
DRN,21990,962,12.8100,100,12.8000,12.8000,20006,1984
SPTS,21988,145400,30.7000,127575,30.6900,30.6900,21988,0
CP,21947,1,350.3300,28,349.5400,350.0500,21533,414
ANIX,21925,2600,4.4500,100,4.3500,4.3900,21665,260
XPO,21904,100,121.1900,9,120.7000,120.7100,21001,903
SNV,21903,100,37.3700,49,37.2400,37.3600,21851,52
UE,21901,314,14.2600,6,14.2400,14.2400,21599,302
CATO,21876,102,11.4900,100,11.4300,11.4500,21875,1
MERC,21853,73,12.2800,100,12.1900,12.1900,21753,100
RDVY,21787,1300,41.3600,700,41.3400,41.3500,21787,0
NGA+,21748,100,10.2300,300,10.0800,10.0250,12337,9411
EYES,21705,600,1.9000,2,1.8900,1.8950,21705,0
SPSM,21702,336,39.0300,100,39.0100,39.0200,21502,200
SVRA,21694,4,1.7600,1200,1.7300,1.7600,21694,0
EGOV,21679,94,29.1400,100,29.1000,29.1400,21420,259
LQDT,21650,200,17.8300,100,17.6700,17.7500,21240,410
QLGN,21607,1500,3.5000,500,3.4500,3.4650,19807,1800
BEPC,21576,100,59.9800,380,59.8700,59.8700,21171,405
GWPH,21575,100,139.2600,100,138.5000,138.9700,20378,1197
XPER,21547,200,21.5900,100,21.4900,21.6000,21546,1
GRIL,21544,1200,2.1400,1100,2.0700,2.0900,16721,4823
ANTE,21516,300,2.5200,300,2.4700,2.4700,19785,1731
TX,21467,100,30.0900,9,29.9300,29.9600,21464,3
EVH,21426,99,18.2000,1,18.1700,18.1900,21426,0
SWI,21421,100,15.9200,7,15.8900,15.9000,19957,1464
TCRR,21392,200,29.1800,200,28.9000,29.1000,21057,335
CRNC,21373,106,121.1700,15,120.6700,120.8500,21322,51
MLSS,21308,100,2.7800,100,2.7500,2.7500,19808,1500
FLS,21298,100,38.7600,200,38.7300,38.7400,21098,200
AVT,21283,100,39.7300,20,39.6700,39.6800,20632,651
MTZ,21260,152,81.1900,200,81.1000,81.2200,20858,402
CONX,21253,300,10.5300,300,10.4300,10.4900,10720,10533
GRMN,21224,100,124.3300,41,124.1900,124.2300,20823,401
PDAC,21215,92,12.2500,64,12.2200,12.2100,13192,8023
MCK,21209,28,183.0200,100,182.8100,182.9500,20473,736
AMCI,21196,100,17.4200,100,17.1000,17.2500,21033,163
CETX,21177,100,1.6600,62,1.6400,1.6500,19527,1650
TECL,21167,100,433.7100,100,433.3800,433.2350,17763,3404
SMTC,21153,100,82.6900,1,82.6400,82.6600,20951,202
WPF,21139,200,12.0400,100,11.9800,11.9700,14125,7014
RGLS,21133,900,1.2100,1619,1.2000,1.2000,21133,0
BAK,21127,200,9.2800,300,9.2600,9.2700,20927,200
WLTW,21122,24,209.5900,100,209.3000,209.4500,20844,278
AKTS,21117,200,15.3200,200,15.2700,15.3000,20917,200
ARWR,21080,100,80.4400,28,80.2500,80.2900,20856,224
GCO,21072,100,37.0800,100,36.8500,37.0000,20829,243
GSKY,21055,600,4.8200,200,4.8100,4.8100,21055,0
TDS,21044,100,20.4800,100,20.4600,20.4800,20092,952
BALY,21042,1,50.0000,9,49.9400,50.0400,21042,0
RLGT,21020,408,6.4200,117,6.4000,6.4200,12831,8189
WEC,20988,102,88.1000,100,88.0200,88.0900,20387,601
ENS,20970,100,92.3500,1,92.0900,92.1600,20828,142
AL,20969,35,43.5700,100,43.5200,43.5200,20350,619
ASAN,20956,200,39.8800,179,39.7200,39.8600,20505,451
SWBK=,20913,600,12.2300,100,12.2200,12.2300,20078,835
PBW,20898,100,130.2600,1,130.0500,130.1600,20854,44
IIPR,20886,100,197.6000,18,195.8100,196.4400,20841,45
ACTG,20879,100,6.1900,1800,6.1100,6.1600,20428,451
PXLW,20871,200,3.2300,300,3.2200,3.2200,19496,1375
TCBI,20870,3,66.8100,100,66.3100,66.6000,20870,0
YETI,20867,100,72.5200,11,72.2200,72.2000,20583,284
EMHY,20830,4600,45.7400,300,45.7100,45.7200,19729,1101
ARAY,20804,200,5.1200,300,5.1100,5.1200,19494,1310
RCUS,20800,57,37.5100,2,37.3300,37.3400,20599,201
VRRM,20799,10,13.1000,204,13.0700,13.0900,20755,44
WYND,20795,198,49.5500,1,49.4400,49.5400,20781,14
APRE,20780,400,5.8200,100,5.8000,5.8200,20320,460
BLI,20770,100,83.1000,49,82.9100,83.0600,20445,325
TINV,20741,100,10.6200,100,10.5100,10.5400,20541,200
BC,20725,109,91.0800,17,90.9000,90.9300,19125,1600
REG,20713,100,47.0400,200,47.0000,46.9800,20536,177
ALE,20693,100,66.0400,100,65.9200,66.0300,20643,50
YUM,20683,147,108.3500,100,108.2600,108.3200,18148,2535
RMBS,20673,261,20.6000,400,20.5600,20.5400,20094,579
NUVA,20671,100,57.2800,100,57.2200,57.2900,20571,100
OESX,20644,100,11.4700,100,11.4000,11.4400,19931,713
CHNR,20642,300,1.8400,500,1.8200,1.8400,20426,216
BGS,20640,300,29.6900,200,29.5000,29.5900,18986,1654
IPO,20630,100,70.0400,100,69.9500,70.0400,20630,0
NYT,20630,100,49.9000,56,49.8800,49.8800,20401,229
FMC,20626,100,115.1300,8,114.9700,115.0200,20522,104
LPTH,20619,100,4.1600,1700,4.1300,4.1800,20335,284
FFIC,20614,100,18.9200,104,18.7800,18.8000,20582,32
NJR,20585,100,35.2000,200,35.1300,35.1700,20476,109
SQNS,20571,100,7.9600,100,7.8900,7.9300,19682,889
BIOC,20541,100,6.2900,100,6.1900,6.2600,19869,672
CPHI,20524,60,0.7400,100,0.7230,0.7200,19321,1203
GH,20508,100,162.4600,100,161.1600,161.5000,18577,1931
ALSK,20496,2114,3.2900,59090,3.2800,3.2900,20496,0
MDC,20487,100,54.3300,100,54.0900,54.0700,19472,1015
PPC,20472,23,20.2200,100,20.1700,20.2200,20139,333
ETR,20443,100,94.0900,100,93.9900,94.0100,20280,163
PRGX,20351,520,7.6300,400,7.6200,7.6300,20351,0
YALA,20329,100,18.4200,100,18.2000,18.2100,16912,3417
VITL,20292,400,24.7900,181,24.6300,24.6000,19365,927
MINT,20289,2331,102.1200,1868,102.1100,102.1200,16789,3500
ENOR,20288,800,26.5900,1500,26.4700,26.4800,20288,0
URA,20279,100,15.4400,400,15.2700,15.3200,20134,145
RWR,20252,900,87.3600,400,87.3300,87.3700,20249,3
CEO,20247,100,104.2300,100,103.8300,104.1100,20005,242
CCI,20227,100,159.3000,100,159.1700,159.1800,19486,741
ZI,20222,3,46.4700,200,46.3300,46.4700,18451,1771
HTBX,20208,100,7.1100,200,7.0900,7.1000,18878,1330
CMG,20186,100,1507.0900,10,1505.6200,1507.0600,19857,329
DHC,20180,500,4.4600,500,4.4500,4.4500,20080,100
ADS,20154,100,71.6900,206,71.4300,71.4300,18824,1330
CVA,20152,200,14.4900,400,14.4800,14.4900,18917,1235
MWK,20151,100,24.2700,100,23.7800,23.9500,18173,1978
BSN,20144,100,10.2500,100,10.2200,10.2800,20144,0
AMH,20133,212,31.1700,2,31.1600,31.1700,17254,2879
CCEP,20128,100,48.5700,49,48.4300,48.5500,19618,510
GTN,20126,100,16.7600,32,16.7400,16.7400,19534,592
CTAC=,20123,100,11.0900,400,10.9900,11.0000,18623,1500
SCYX,20106,100,7.4100,1200,7.3400,7.3900,20106,0
XHR,20106,154,15.9700,8,15.9600,15.9700,19620,486
REZI,20080,162,25.1900,101,25.0800,25.0800,19479,601
PNM,20069,100,48.6500,100,48.6300,48.6400,19123,946
CXP,20066,10,14.2800,300,14.2600,14.2700,18060,2006
CDAY,20033,212,104.3300,100,103.9300,104.2400,20015,18
TMF,20028,800,30.8700,800,30.8500,30.8600,18680,1348
AJRD,19920,339,52.8200,100,52.7800,52.8100,19613,307
FR,19886,90,42.1400,10,42.1200,42.1200,19868,18
WLL,19872,100,24.8500,500,24.4700,24.3800,17231,2641
WK,19864,100,101.4200,100,100.3500,100.7900,19719,145
FAX,19778,1600,4.4300,800,4.4200,4.4200,19478,300
ARLO,19743,100,8.4000,200,8.3700,8.3700,19405,338
BCC,19734,100,52.1400,100,52.0400,52.1200,19707,27
TRN,19723,400,28.2100,100,28.0500,28.1300,18340,1383
ITCI,19722,4,32.9800,11,32.9300,32.9100,19715,7
TMV,19702,500,60.9200,500,60.8900,60.9200,19602,100
AVXL,19690,300,5.7900,100,5.7600,5.7900,19134,556
CODX,19663,100,11.8600,200,11.8300,11.9100,18179,1484
PIPP=,19650,290,14.0900,500,13.9600,14.0000,19564,86
KLR,19628,100,12.1900,100,12.0300,12.1250,19628,0
BHAT,19612,300,1.2900,200,1.2600,1.2800,19466,146
VTIP,19574,12200,51.3800,5900,51.3700,51.3750,19567,7
POSH,19542,220,74.0000,1,73.3200,73.7000,18841,701
TXG,19539,100,184.7700,200,184.5900,184.6300,18732,807
ARRY,19536,100,49.5100,100,49.3900,49.3900,19391,145
PRCH,19520,100,18.1000,100,17.9700,18.0950,19444,76
DIN,19516,10,73.7000,17,73.6000,73.6400,19516,0
SLS,19510,100,6.0000,100,5.9400,5.9600,19310,200
BSCP,19500,900,22.5100,100,22.5000,22.5000,14537,4963
RXN,19493,53,41.5200,100,41.3900,41.2800,19244,249
KC,19462,100,45.6300,46,45.4400,45.6500,18813,649
RCII,19458,100,47.5600,257,47.2800,47.3200,19356,102
SJM,19408,100,113.4900,1,113.4400,113.5500,19031,377
CEVA,19405,100,64.6600,200,64.3400,64.4000,18958,447
FFBC,19391,402,20.2100,300,20.1600,20.1900,19388,3
BDX,19377,77,262.1900,133,262.1100,262.1400,18296,1081
GNPX,19355,300,3.8000,100,3.7800,3.7800,19061,294
SHOO,19355,2,35.1600,57,35.0700,35.1400,19354,1
AAXN,19349,100,164.3800,1,163.7600,164.0900,19229,120
GSEW,19310,800,59.6800,6120,59.6400,59.6400,19310,0
PSA,19288,100,222.2500,100,221.9900,222.1300,18966,322
SCPE,19286,100,10.5800,100,10.4500,10.5000,2164,17122
VERU,19281,101,8.9000,200,8.8700,8.8800,19278,3
CHGG,19265,150,101.2400,7,101.1800,101.1700,19160,105
ORCC,19259,900,13.4100,300,13.3900,13.4000,18559,700
CUBE,19207,189,34.8600,100,34.8000,34.8100,19113,94
PTC,19204,3,129.6600,9,129.5500,129.6200,19103,101
MNR,19190,100,17.6700,800,17.6500,17.6600,16153,3037
DSKE,19168,100,6.0400,100,5.9800,6.0300,18968,200
IFMK,19161,2500,1.0800,100,1.0600,1.0700,19161,0
UGP,19135,5026,4.2400,2500,4.2300,4.2300,19135,0
APH,19124,41,133.9000,131,133.8200,133.8300,18932,192
CNST,19119,100,34.9400,100,34.6200,34.7700,19019,100
HLAHU,19116,100,10.7200,200,10.6500,10.6500,19116,0
CFX,19088,5,40.0600,1,39.9800,40.0600,18988,100
VERB,19069,49,1.8300,20,1.8000,1.8100,18969,100
BOWX,19067,100,11.0900,200,11.0200,11.0200,17912,1155
PLAN,19066,3,71.8500,43,71.6200,71.8600,18189,877
GTT,19060,406,3.8300,200,3.7900,3.8100,18733,327
NCTY,19052,200,9.1600,100,9.0400,9.0600,18835,217
VRA,19052,100,8.4700,100,8.4400,8.4500,19052,0
FVRR,19042,100,245.4200,100,244.0200,244.1400,18784,258
CFFN,19033,700,13.0200,432,13.0100,13.0100,18632,401
COOP,19003,2,29.8200,200,29.7600,29.7600,18517,486
BSM,18993,100,8.3200,100,8.2700,8.2800,18879,114
SPRQ,18938,200,11.2800,200,11.2100,11.1900,18938,0
DXCM,18937,100,368.2600,14,367.7700,368.2000,18455,482
FROG,18931,100,63.4000,122,63.1200,63.3500,18597,334
LILAK,18921,100,10.7600,1,10.7500,10.7500,18921,0
KRG,18909,100,16.3900,580,16.3700,16.3800,18736,173
DBA,18908,800,16.4700,1857,16.4600,16.4650,18781,127
SOI,18904,1,9.7600,101,9.7200,9.7500,18687,217
PDCO,18875,102,31.5800,12,31.5600,31.5700,18875,0
BIIB,18861,20,269.5800,19,269.3600,269.3400,18821,40
DHF,18857,3800,2.9900,4959,2.9800,2.9800,18856,1
GWB,18857,1,23.1400,2,23.0900,23.1000,18557,300
AYX,18855,100,124.7200,11,124.1800,124.2900,15950,2905
TUP,18839,300,31.7300,72,31.5700,31.5600,18438,401
DRI,18822,100,125.3800,44,125.1900,125.2900,18123,699
BNO,18794,6500,13.9600,7400,13.9400,13.9350,15694,3100
CWB,18771,100,87.7100,100,87.5500,87.5900,18071,700
MTOR,18763,193,27.8100,200,27.7900,27.8100,17798,965
BERY,18756,100,53.4500,200,53.3000,53.3300,18756,0
FBM,18735,700,19.2300,3916,19.2200,19.2300,18635,100
IPOE=,18722,400,24.2600,500,24.1400,24.2200,18422,300
ACCO,18721,100,8.6600,296,8.6400,8.6500,18721,0
PFG,18678,2,53.4900,193,53.4500,53.4700,18257,421
KBWB,18673,100,53.7500,100,53.7400,53.7800,17773,900
EDOC,18650,1500,21.5400,21,21.5200,21.5600,18150,500
ZYXI,18629,100,16.6500,100,16.4900,16.6300,18490,139
RGR,18603,200,67.3600,15,67.0700,67.0700,18367,236
PRGO,18587,203,43.4500,100,43.4100,43.4700,17373,1214
CRHC,18582,100,10.7300,201,10.6700,10.7100,12320,6262
BDTX,18580,100,26.2900,100,26.0200,26.0900,18481,99
ORIC,18538,100,33.2900,100,32.8700,32.9900,18527,11
PGEN,18532,100,9.3100,195,9.2500,9.2800,17632,900
GMLP,18525,3750,3.4300,2402,3.4200,3.4300,18000,525
OIH,18475,300,169.4500,200,169.1500,169.2700,15623,2852
GDS,18473,2,109.2600,100,108.8700,109.1400,17887,586
VERI,18470,100,39.9700,7,39.7100,39.7500,18469,1
ALRM,18449,2,96.3000,66,96.0000,96.0200,18239,210
RGP,18436,76,12.4900,100,12.4000,12.4400,18164,272
AUMN,18418,3,0.7030,500,0.7020,0.7026,17618,800
TT,18414,16,154.6400,100,154.5200,154.5800,17957,457
AJAX=,18379,375,13.0000,900,12.9400,12.9800,13879,4500
JEF,18342,103,25.9000,100,25.8900,25.9100,17453,889
GLYC,18321,200,3.8500,200,3.8300,3.8400,18121,200
FND,18319,23,103.5600,100,103.0300,103.5100,18175,144
CLB,18309,142,34.2900,139,34.0100,34.0900,18156,153
GCMG,18306,10,13.5000,100,13.4000,13.3800,17906,400
TRVG,18300,600,2.1700,600,2.1600,2.1600,16300,2000
WWE,18300,100,52.7900,100,52.5800,52.5900,18299,1
DNB,18287,100,25.0100,247,24.9600,24.9800,17687,600
ZBH,18277,12,163.3900,2,163.2500,163.3100,16914,1363
FENY,18258,7400,11.4100,2500,11.4000,11.4100,14812,3446
FLXN,18247,100,11.5200,100,11.4400,11.4800,15414,2833
NEWR,18233,39,79.4800,600,79.4200,79.4700,16124,2109
SLG,18230,100,63.3400,200,63.2500,63.3400,17485,745
SEAC,18221,8820,1.2900,3111,1.2800,1.2800,18221,0
FXN,18216,7800,8.8900,1800,8.8800,8.8300,18216,0
AROC,18210,1000,9.4400,1100,9.4200,9.4400,17112,1098
HOMB,18202,100,21.2400,41,21.1800,21.2200,18196,6
PFS,18195,4,19.3100,100,19.2800,19.2850,18195,0
BSJM,18182,4100,23.2900,552,23.2800,23.2850,16382,1800
EBIX,18180,400,44.8300,21,44.7200,44.8000,18179,1
PRSP,18174,76,26.3200,200,26.3100,26.3100,18171,3
IMO,18172,100,20.7900,100,20.7600,20.7500,16522,1650
HCSG,18167,100,31.3200,100,31.0900,31.1800,18092,75
INAQ,18159,100,16.6400,100,16.5800,16.6400,17385,774
PID,18159,100,16.2800,1300,16.2400,16.2600,18159,0
BRY,18153,200,4.2700,245,4.2500,4.2500,18153,0
AWI,18141,139,80.4700,12,80.1600,80.2000,17941,200
HDV,18113,1000,89.5900,1600,89.5600,89.5700,18113,0
WHD,18103,103,28.1500,200,27.9900,28.1500,17956,147
GRSV,18102,100,11.0200,500,10.9300,10.9500,17908,194
PANW,18102,200,366.4800,100,365.5600,365.8500,16263,1839
STRO,18095,98,26.0900,100,26.0200,26.0900,17995,100
CERN,18092,100,79.9700,68,79.9100,79.9400,17325,767
ETN,18089,100,125.4700,241,125.4300,125.4300,17777,312
VVNT,18087,100,20.5200,100,20.3000,20.4400,17833,254
SMAR,18070,100,71.0900,100,70.6100,70.9100,18042,28
MHO,18043,5,53.2200,100,53.1200,53.1500,18042,1
OTLK,18034,300,1.3100,791,1.3000,1.3000,18034,0
MTRX,18017,199,13.3100,100,13.2200,13.3200,17859,158
LBRT,17986,310,12.0700,34,12.0400,12.0500,17886,100
ATAX,17981,500,4.3800,100,4.3300,4.3700,17913,68
IAT,17979,600,49.0400,400,49.0100,49.0400,16479,1500
TAC,17943,900,8.8800,400,8.8700,8.8800,16843,1100
ZLAB,17943,15,182.9500,100,182.6500,182.9500,16724,1219
CDTX,17932,200,2.4100,100,2.3900,2.4000,11707,6225
DPZ,17932,201,380.8000,200,380.6100,380.8200,17307,625
LHX,17921,1,183.5200,1,183.3800,183.2300,17435,486
SPTI,17917,43915,32.8800,39486,32.8700,32.8800,17917,0
EWM,17912,500,27.9700,800,27.9600,27.9650,17912,0
E,17898,100,21.0700,100,21.0500,21.0600,17771,127
CWK,17890,100,14.9300,400,14.9000,14.9100,17871,19
PEGA,17887,100,143.2300,101,142.5300,142.5000,17225,662
XYLD,17868,500,47.1200,490,46.8300,46.9000,17868,0
ATRO,17847,100,14.3800,200,14.3100,14.3200,17847,0
RETO,17846,400,0.9300,500,0.9200,0.9258,16988,858
APSG,17839,100,10.9300,100,10.9100,10.9300,16971,868
CNET,17817,300,2.4000,500,2.3800,2.3900,17516,301
GP,17808,100,30.4900,3,30.3900,30.4500,17535,273
PNW,17807,100,77.8300,4,77.7600,77.8000,17745,62
TTEK,17805,100,134.7500,100,134.1500,134.7400,17112,693
LEG,17802,100,44.9100,300,44.8400,44.8800,17660,142
CSTL,17793,1,80.7400,5,79.7100,79.7800,17775,18
LPG,17785,100,12.8000,118,12.7800,12.7800,17282,503
HEAR,17784,102,25.1500,84,25.1200,25.1200,17405,379
RTLR,17784,100,9.5800,100,9.5300,9.5700,17784,0
ADNT,17781,100,35.6300,202,35.4000,35.3600,17281,500
QELL,17776,70,14.0000,100,13.9100,13.9700,17176,600
ATO,17772,100,89.8300,200,89.7000,89.7600,17626,146
XYL,17770,100,103.3400,5,103.2500,103.2700,17580,190
COUP,17757,200,341.5100,4,341.0200,341.4500,17090,667
MDNA,17740,100,4.4000,100,4.3600,4.4000,15740,2000
VGR,17740,652,12.2300,135,12.2200,12.2200,17636,104
BHF,17726,100,41.6100,192,41.4100,41.4500,17646,80
CEIX,17721,21,8.8600,300,8.8400,8.8500,17270,451
BRKL,17717,100,13.0200,100,12.9900,13.0000,17716,1
KNL,17717,100,16.1400,100,16.0900,16.1300,17717,0
BF.B,17712,100,73.0400,103,72.9800,73.0000,17296,416
RBBN,17675,100,7.0200,100,6.9800,7.0100,17475,200
CTK,17646,100,3.5200,100,3.4300,3.4300,17346,300
UBSI,17618,100,35.4600,300,35.3400,35.3600,17479,139
XBIO,17600,100,2.5400,100,2.4700,2.5200,17600,0
CTAC,17599,200,10.4700,100,10.4100,10.4800,14992,2607
TBIO,17591,107,22.8400,200,22.7200,22.7900,17460,131
GRA,17588,100,62.0200,1,61.8900,62.0000,17388,200
TOUR,17577,200,2.1400,300,2.1200,2.1300,16455,1122
CASA,17564,100,7.8200,200,7.8000,7.8050,17564,0
FCAC,17500,200,11.0800,200,11.0500,11.0800,17400,100
DEI,17463,204,28.7900,53,28.6900,28.7700,16613,850
ORGS,17452,100,6.4900,100,6.3900,6.2900,17452,0
MDU,17445,658,27.7000,100,27.6600,27.6800,15502,1943
OC,17435,29,86.8300,5,86.5700,86.5900,17031,404
SVAC,17433,524,10.9400,100,10.8800,10.9500,16023,1410
RHP,17432,100,69.1900,1,68.9900,69.0100,17341,91
TBBK,17414,100,16.9600,500,16.8500,16.9400,17414,0
DGX,17376,43,125.6500,42,125.5800,125.5900,16881,495
EEMV,17354,400,63.7900,200,63.7400,63.7400,17202,152
FNDF,17349,1200,30.9200,200,30.9000,30.9100,17258,91
CEMB,17329,4100,52.8100,4000,52.7700,52.7900,16729,600
RSG,17328,100,94.3900,56,94.2800,94.3400,16868,460
JG,17319,100,4.0500,100,4.0000,4.0400,17010,309
INOV,17288,6,25.7800,100,25.7400,25.7900,16987,301
LLIT,17277,100,5.2300,100,5.1300,5.2000,17277,0
ICVT,17258,297,103.3000,400,103.2500,103.2900,17258,0
IONS,17236,50,61.5200,2,61.3100,61.3200,16891,345
ALLT,17234,100,14.5100,700,14.3400,14.4400,11513,5721
USAC,17215,100,16.2600,100,16.0900,16.1500,16815,400
MDB,17213,98,375.0900,200,374.3700,374.5000,17207,6
USEG,17210,200,4.5500,100,4.4500,4.4800,16910,300
CYTK,17201,226,20.2300,200,20.1400,20.2100,17178,23
CHEF,17187,100,28.4800,200,28.4400,28.4000,16955,232
MSM,17164,406,81.9100,25,81.6200,81.9000,16603,561
HLIT,17157,100,8.1600,200,8.1500,8.1600,16957,200
STRA,17143,100,91.1800,100,90.5000,90.8800,15906,1237
SHM,17113,200,49.8100,200,49.7900,49.7950,7564,9549
CCS,17093,300,50.2400,100,49.7800,49.8600,16993,100
NGAC,17083,200,10.4100,100,10.3700,10.4000,10100,6983
HEPA,17074,700,2.3300,500,2.3100,2.3200,16574,500
DCRB,17056,200,12.2900,100,12.2200,12.2300,9269,7787
AMPY,17048,100,2.0400,800,1.9900,2.0200,14848,2200
SF,17044,100,53.2300,200,52.9800,53.1100,16972,72
REYN,17016,100,29.1800,1,29.0500,29.0700,16091,925
EXR,17012,200,114.9700,100,114.9000,114.8700,16378,634
EXG,16992,600,8.9800,400,8.9700,8.9800,16292,700
LBRDK,16975,100,155.8200,100,155.2000,155.4000,16772,203
TDTT,16965,32600,26.2800,400,26.2700,26.2750,16965,0
ATEN,16960,1100,9.7300,1,9.7200,9.7300,15106,1854
RNG,16945,100,376.7300,200,375.3900,375.4900,16604,341
MDP,16941,100,19.0800,135,18.9900,19.0000,16781,160
LGHL,16935,46,3.0900,100,3.0400,3.0900,16529,406
GAB,16926,100,6.4000,1400,6.3800,6.3900,16726,200
SUPN,16909,400,28.6000,100,28.5300,28.6200,16878,31
GPC,16906,100,102.4500,95,102.4100,102.4300,16477,429
MKC,16877,200,91.4500,35,91.3900,91.4400,16533,344
ESGU,16851,800,88.8200,500,88.8000,88.8100,16551,300
NRGU,16847,100,83.2300,16,82.8200,82.8200,16327,520
FCF,16845,101,12.4800,139,12.4700,12.4800,14062,2783
WGO,16840,100,67.3700,3,67.0200,66.9000,16799,41
GNRC,16818,100,273.3800,100,272.4500,273.3900,16331,487
ATH,16814,100,43.9900,200,43.7000,43.8300,16671,143
ZNTEW,16809,100,3.3800,100,3.2100,3.2500,15993,816
CATM,16805,37,41.3800,2,41.2000,41.2200,15519,1286
PLCE,16804,100,65.7400,200,65.5100,65.5700,16682,122
NDAQ,16781,70,141.2100,2,141.1200,141.2100,16411,370
FLO,16771,87,22.2300,100,22.2200,22.2300,16297,474
BPOP,16744,44,59.7900,4,59.6200,59.6900,16252,492
NGL-B,16735,100,13.6500,100,13.4000,13.5300,10467,6268
FHB,16698,254,25.6200,27,25.5700,25.6100,16694,4
FTNT,16697,34,150.3600,44,150.2000,150.0600,15672,1025
VYGR,16691,100,8.6900,1200,8.5900,8.6500,16572,119
GBCI,16688,100,49.7800,69,49.5300,49.5700,16687,1
BRN,16684,100,2.3900,100,2.3400,2.3550,14984,1700
SPHQ,16683,6330,43.1600,900,43.1500,43.1600,16683,0
ZIXI,16682,100,8.3900,600,8.3700,8.3700,15276,1406
LW,16681,100,77.1000,7,77.0200,77.0200,16661,20
CTIC,16668,500,3.2700,500,3.2500,3.2600,16668,0
VTNR,16667,400,1.0800,100,1.0500,1.0600,16467,200
CNR,16635,100,12.9700,200,12.9000,12.9600,16629,6
CBT,16629,90,47.4100,4,47.3400,47.2900,16128,501
EBC,16627,300,16.2100,163,16.1800,16.2000,16195,432
OEF,16620,1300,176.7800,700,176.7300,176.6400,16520,100
RPD,16610,200,91.5500,4,91.1200,91.1100,16309,301
RARE,16608,100,134.3700,21,132.9800,133.6600,16025,583
PPBI,16603,100,35.5300,100,35.3300,35.4100,16496,107
INVA,16593,100,12.4400,23,12.3800,12.3900,12281,4312
RCKT,16593,33,53.1300,100,52.8100,53.0200,16485,108
ONB,16583,200,17.8000,5,17.7700,17.7800,16352,231
QTS,16582,100,64.4900,34,64.2700,64.3100,16290,292
DGRO,16581,900,45.8200,4300,45.8100,45.8100,15881,700
SMM,16575,100,4.9700,1197,4.9000,4.9100,7214,9361
ASMB,16564,202,6.0100,800,5.9900,6.0000,16207,357
GNCA,16549,200,3.2400,200,3.1900,3.2100,16349,200
CRS,16546,100,35.0800,100,34.8300,34.9900,15566,980
SD,16522,1300,4.5800,100,4.5400,4.5500,16097,425
LSCC,16520,72,43.5500,200,43.4900,43.5400,16331,189
SMPL,16505,1,27.3900,100,27.3200,27.3300,16273,232
CVI,16496,100,18.7300,101,18.6200,18.6400,16491,5
SCOAU,16491,100,10.9900,100,10.9000,10.9500,16491,0
ZEN,16483,27,146.7000,1,146.2100,146.2800,15972,511
WTTR,16479,400,5.2400,400,5.2000,5.2000,16457,22
GSIE,16419,1300,32.9000,400,32.8900,32.8800,15819,600
OPTN,16415,1400,4.0800,266,4.0600,4.0650,16415,0
LAZRW,16360,100,20.0000,100,19.8500,20.1000,14344,2016
ELSE,16359,100,4.9800,100,4.8600,4.8100,15879,480
VHT,16333,400,234.8400,300,234.7200,234.9400,6192,10141
GBDC,16329,200,14.8900,100,14.8700,14.8900,16228,101
NWN,16328,100,42.8400,100,42.6900,42.7300,16234,94
ACI,16290,200,17.4400,400,17.4000,17.4200,14826,1464
QS+,16269,100,33.6300,100,32.7700,33.3400,13534,2735
IJJ,16205,19,91.3900,400,91.3500,91.3900,16195,10
ERUS,16198,300,39.2000,50,39.1800,39.2100,16022,176
DBO,16191,27000,9.2400,22400,9.2300,9.2300,16091,100
WB,16184,200,42.7200,3,42.6900,42.7000,15865,319
ACAD,16169,200,52.5700,300,52.2000,52.4000,16169,0
EB,16152,600,18.7600,100,18.6500,18.6500,16152,0
IAGG,16149,300,55.8600,406,55.8300,55.8500,16049,100
NAVB,16116,3000,2.2600,2,2.2400,2.2600,16066,50
KEYS,16110,35,147.2400,1,147.1500,147.1500,15891,219
KIE,16084,600,34.3300,600,34.3100,34.3200,15984,100
SIBN,16054,100,30.7100,100,30.4500,30.4800,15909,145
GIII,16053,100,27.1900,68,27.0100,27.1100,16036,17
REPL,16051,18,44.0500,200,43.7800,44.0300,15926,125
AJG,16041,100,119.4800,67,119.3800,119.4200,15020,1021
ATAC,16037,200,10.9000,200,10.8200,10.8600,15337,700
WMS,16032,100,90.9500,101,90.8400,90.8100,15973,59
NTRA,16021,1,120.2900,100,119.9900,120.1100,15847,174
IR,16020,100,46.1300,200,46.0900,46.0800,15820,200
ABC,16003,100,105.0400,1,104.9700,105.0700,15846,157
CRTD,15994,100,5.1600,400,5.0100,5.0800,13421,2573
SGBX,15982,100,7.9900,100,7.8700,7.9300,15538,444
GOCO,15966,100,15.1600,104,15.0600,15.0900,15766,200
PRGS,15945,100,41.9000,100,41.8400,41.8100,15945,0
ALGN,15929,100,547.1400,200,546.5900,547.1300,15820,109
CSPR,15926,100,7.3500,100,7.3000,7.3100,15226,700
NTEC,15914,74,4.5300,975,4.4800,4.5100,15514,400
FRC,15907,100,154.2800,33,154.1100,154.1800,15435,472
RPT,15876,100,9.2700,300,9.2500,9.2500,15379,497
CJJD,15860,100,1.2000,100,1.1600,1.2000,12908,2952
VNDA,15849,9,14.6400,100,14.6100,14.6200,15706,143
CCAC,15843,100,10.7400,102,10.7000,10.6800,15843,0
VNOM,15842,90,14.4600,100,14.3700,14.4600,15342,500
FIVN,15838,100,180.4700,4,179.6200,179.9200,15290,548
PAG,15832,100,66.5000,200,66.4200,66.4500,15727,105
TENB,15832,2,55.6800,200,55.6200,55.6500,15135,697
FAII,15810,100,11.8600,100,11.8000,11.8200,13407,2403
FTOCW,15804,100,3.5800,100,3.4900,3.5500,15204,600
COLD,15798,200,35.1500,400,35.0500,35.1400,15497,301
LTRN,15795,100,15.5500,100,15.3200,15.4650,15595,200
EPRT,15792,157,20.6800,400,20.6700,20.6800,15605,187
MYGN,15790,10,26.8500,1,26.8300,26.8400,15550,240
PRPH,15779,100,11.3000,200,11.1500,11.2500,14621,1158
XPL,15758,100,0.7040,100,0.7012,0.7025,14458,1300
DOOR,15753,7,108.5900,100,107.8300,108.4200,15439,314
AEL,15750,100,30.2300,400,30.0700,30.2300,15749,1
RLAY,15693,2,57.9600,100,57.4700,57.7500,15258,435
EQOS,15673,100,16.1900,100,16.0700,16.1800,14643,1030
EXPD,15673,100,94.4200,12,94.3400,94.3600,15564,109
LGIH,15656,19,110.3600,118,110.1900,110.3100,15636,20
SRGA,15643,100,2.1400,200,2.1200,2.1400,15525,118
CURO,15638,6,14.8400,100,14.7400,14.8300,15538,100
VSAT,15637,26,39.2900,100,39.2200,39.2700,14667,970
TK,15630,200,2.7300,200,2.7200,2.7200,14306,1324
TM,15625,100,150.9800,2,150.9300,150.9300,15125,500
LFTR,15620,100,10.9000,100,10.8400,10.9000,14319,1301
FUL,15616,100,53.8000,100,53.7700,53.7900,15602,14
STIM,15602,100,18.5900,100,18.2400,18.4500,15402,200
ETH,15584,100,23.8200,200,23.7800,23.7400,15365,219
SHV,15550,4900,110.5200,454990,110.5100,110.5150,15550,0
TPRE,15549,101,9.8500,9,9.8100,9.8400,15538,11
INT,15548,100,32.6500,63,32.5900,32.5900,15448,100
BBCA,15547,1500,27.8700,400,27.8600,27.8600,15547,0
GIM,15531,1100,5.6100,1400,5.6000,5.6050,15531,0
IHI,15531,100,339.0500,100,338.8800,338.9100,15531,0
AGCB,15505,100,14.0100,100,13.8500,13.9700,14940,565
EWD,15496,400,42.1600,100,42.1100,42.1000,14796,700
AWK,15477,3,160.9800,100,160.8400,161.1800,14034,1443
TPIC,15463,1,68.5700,200,68.4900,68.5500,14941,522
ADTN,15462,100,17.1100,305,17.0300,17.0400,15262,200
ASO,15450,100,21.9700,100,21.9300,21.9600,14811,639
HXL,15444,10,48.5900,200,48.5000,48.5300,15004,440
CAPR,15443,2100,5.4100,200,5.3600,5.3700,15443,0
HYRE,15435,100,7.6600,200,7.5500,7.5700,14235,1200
BNFT,15429,200,13.8200,12,13.7700,13.8200,14059,1370
PNR,15422,44,57.5300,10,57.5000,57.5100,15294,128
MTA,15412,100,11.7900,96,11.7300,11.7300,14985,427
SMTX,15404,2600,5.8900,1900,5.8800,5.8800,15404,0
SIVB,15398,11,457.9200,100,457.1200,457.1200,15023,375
HIBS,15388,500,26.2300,500,26.1800,26.1900,15388,0
HSII,15381,5,31.8100,4,31.7800,31.8100,15381,0
LPTX,15372,1,2.4400,200,2.4100,2.4200,15372,0
FRPT,15350,103,145.7700,100,144.9500,145.4900,14425,925
WRE,15349,101,22.3200,202,22.2900,22.3200,15149,200
APRN,15336,300,7.1800,1645,7.0900,7.1400,15336,0
EDV,15325,400,144.2200,400,144.0300,144.0700,13951,1374
IMAX,15322,100,18.1900,108,18.1700,18.1700,14967,355
SSSS,15318,100,14.0100,100,13.9000,13.9900,15318,0
AN,15309,5,77.5300,100,77.2300,77.5100,15078,231
VGSH,15300,104865,61.6200,17380,61.6100,61.6100,15300,0
BLFS,15299,100,43.1600,100,42.8200,43.2100,14923,376
SCI,15287,100,51.7900,11,51.7600,51.7600,15055,232
CBRE,15278,100,64.9900,100,64.9500,64.9900,14997,281
ST,15272,100,56.8500,100,56.7500,56.7800,14903,369
GMS,15249,400,32.5600,100,32.3600,32.3700,15223,26
GNMK,15233,4,14.6900,107,14.6600,14.6800,14657,576
RVLV,15210,100,35.2400,103,35.2000,35.2100,14550,660
VMC,15201,146,158.7000,1,158.5400,158.6200,14500,701
IQV,15200,2,187.9100,100,187.7800,187.8700,14696,504
XPEL,15197,39,54.9500,19,54.3900,54.5600,15194,3
SJB,15189,2443,18.6400,500,18.6300,18.6300,14059,1130
NRBO,15188,100,5.0800,100,4.9700,4.9800,15088,100
SBAC,15171,20,272.3600,90,272.1700,272.1900,14499,672
CLVR,15156,200,9.8800,200,9.7700,9.8300,14080,1076
HCA,15145,231,167.5100,31,167.3800,167.4500,14554,591
QNST,15145,100,21.7700,210,21.7400,21.7700,15139,6
STPZ,15133,700,54.5900,100,54.5800,54.5700,15133,0
CMRE,15131,600,8.6000,400,8.5700,8.5700,15131,0
TEDU,15112,300,3.1600,200,3.1100,3.1500,15112,0
GIL,15106,199,26.5600,111,26.5400,26.5300,14979,127
TPC,15084,9,16.5800,200,16.5200,16.5600,14433,651
KLIC,15073,100,38.5000,100,38.2600,38.3500,14567,506
FNKO,15067,23,11.6300,100,11.5800,11.6300,14972,95
BBAX,15066,2400,28.6100,800,28.5900,28.5900,13566,1500
AYTU,15060,100,7.9400,300,7.8800,7.9100,15060,0
VOXX,15055,100,21.3500,59,21.0900,21.2100,15055,0
DOG,15052,4790,38.3500,1800,38.3400,38.3400,14658,394
BSIG,15037,7,21.0000,100,20.9900,21.0200,14134,903
AYI,15006,34,122.6800,12,122.5100,122.6100,14588,418
RCON,14998,1,1.9600,1000,1.9000,1.9350,14998,0
ARNA,14976,22,77.1500,30,76.7700,77.0700,14974,2
NARI,14972,20,105.1400,20,105.0600,105.1100,14372,600
PNFP,14947,2,71.3700,30,71.1600,71.2900,14937,10
MHK,14946,1,151.7100,1,151.5500,151.6500,14784,162
INDO,14940,100,6.4500,100,6.1700,6.3200,14223,717
HUSN,14925,500,3.7900,100,3.7100,3.7700,13925,1000
CNFR,14908,1800,3.0800,1900,2.9200,3.0000,14706,202
BCO,14897,101,73.8000,100,73.6600,73.7200,14894,3
MIME,14896,147,45.0900,100,44.8100,44.9500,14385,511
FRTA,14889,300,20.7400,200,20.6200,20.6500,13399,1490
RAVN,14883,100,36.0200,100,35.9200,36.0000,14780,103
CSLT,14879,100,1.7000,200,1.6900,1.7100,14379,500
DCPH,14879,100,47.6300,100,47.4600,47.5600,14776,103
PHAS,14869,700,4.2500,100,4.1500,4.2000,14869,0
MITO,14868,5,1.7500,300,1.7000,1.7150,13734,1134
STRL,14868,100,23.8000,200,23.6200,23.7300,14792,76
OPI,14863,100,26.1300,100,25.9800,25.9900,14560,303
BCDA,14857,100,4.3800,100,4.2700,4.2750,13179,1678
LMNX,14849,100,28.2200,200,28.1900,28.2100,14649,200
NATI,14836,100,45.0300,10,44.9500,44.9600,14783,53
OSW,14834,200,9.1400,182,9.0800,9.1100,14533,301
SCHH,14833,2400,38.1000,1119,38.0900,38.1000,11033,3800
LH,14827,123,228.6200,22,228.3400,228.4100,14003,824
ITW,14821,100,204.7400,2,204.6300,204.6600,14527,294
TBI,14810,100,19.7800,100,19.7600,19.8000,14810,0
HMC,14800,100,28.3300,100,28.2900,28.3300,11442,3358
ENVB,14769,400,4.0400,476,3.9600,3.9700,14551,218
J,14760,100,111.5700,146,111.4600,111.5500,14019,741
FINV,14746,100,3.6800,2100,3.6500,3.6750,14246,500
QUOT,14708,100,10.1100,201,10.0900,10.1000,14708,0
AXTI,14704,300,11.8900,100,11.7900,11.8400,14689,15
KORU,14703,100,52.3600,100,52.3200,52.3200,14568,135
IMMR,14701,100,13.6600,100,13.6000,13.6600,14501,200
KURA,14694,100,34.1200,100,33.9500,34.0400,13849,845
XMLV,14668,500,49.5300,200,49.5100,49.5100,14668,0
PFXF,14655,100,20.6500,600,20.6400,20.6500,9601,5054
ENIC,14646,111,4.1700,200,4.1600,4.1600,14568,78
UCBI,14644,100,30.4700,300,30.4100,30.4600,14643,1
QYLD,14639,200,23.1700,201,23.1500,23.1550,14629,10
PAQCU,14628,100,11.7300,1100,11.6800,11.7000,14250,378
EMN,14626,8,106.2200,100,106.1500,106.1700,14313,313
CEMI,14620,100,6.1900,200,6.1700,6.1900,14283,337
SXC,14604,200,5.4700,100,5.4500,5.4600,13564,1040
ABR,14600,200,14.6400,810,14.6300,14.6300,14308,292
RGS,14598,200,9.3600,300,9.3400,9.3800,13897,701
IPOF=,14582,400,17.2000,400,17.1200,17.2400,11972,2610
ARVN,14569,100,84.7000,20,84.4100,84.4700,14464,105
EPC,14558,200,34.1800,100,34.0200,34.0600,14557,1
BMO,14547,200,77.9200,100,77.8900,77.9100,14117,430
CLXT,14511,100,7.7400,310,7.6900,7.7000,14361,150
GRSVU,14504,500,11.4900,500,11.3800,11.4000,14504,0
CMP,14500,83,62.3500,21,62.2600,62.2900,14500,0
FTS,14497,300,41.3900,101,41.3700,41.3700,13076,1421
PASG,14480,99,23.4400,100,23.2600,23.3900,13537,943
MFGP,14474,1000,5.5500,1400,5.5300,5.5400,13174,1300
BTN,14465,100,2.0700,300,2.0300,2.0200,14365,100
TWCT,14459,100,11.0400,100,10.9500,10.9500,13184,1275
UTZ,14448,400,22.6300,800,22.5000,22.5600,14146,302
SLRX,14446,4000,1.3000,4300,1.2500,1.2750,10956,3490
RMED,14432,100,7.4400,100,7.3200,7.4150,9554,4878
CARS,14411,300,13.8400,100,13.8000,13.8300,13896,515
MIE,14411,1200,2.4600,100,2.4100,2.4600,6850,7561
NBR,14409,100,60.4000,100,59.9900,59.9800,14409,0
BIPC,14408,100,68.2700,100,67.5800,67.8200,14208,200
AVA,14397,100,38.3900,214,38.3500,38.3800,14371,26
GOGL,14358,200,5.5100,600,5.5000,5.5000,13773,585
CASI,14346,100,3.2800,200,3.2400,3.2900,14246,100
NML,14306,300,3.7700,1000,3.7600,3.7600,11600,2706
BOWXU,14286,400,11.8200,400,11.7400,11.7200,14246,40
ASTC,14278,300,2.3400,500,2.3000,2.3300,14228,50
TRI,14267,100,81.6300,200,81.5900,81.6000,13760,507
ADC,14261,10,64.3900,3,64.3100,64.3500,14095,166
HCAT,14261,100,48.6000,100,48.3000,48.5300,14261,0
QLI,14247,300,8.3000,174,8.1600,8.2950,10549,3698
ESML,14236,100,36.8800,100,36.8500,36.8600,14236,0
JBL,14220,49,45.9500,400,45.6700,45.8000,14171,49
STAG,14210,7,30.9900,296,30.9700,30.9700,13978,232
VSTO,14186,100,28.1800,16,28.1500,28.1600,12431,1755
GNK,14176,100,8.7500,100,8.7300,8.7200,14174,2
BBDC,14164,200,9.2000,100,9.1700,9.1900,14002,162
PLAB,14142,100,12.1900,236,12.1300,12.1400,14141,1
JOBS,14127,100,69.5900,100,68.8800,69.3700,14114,13
VO,14119,200,214.6600,100,214.5900,214.6400,14119,0
PH,14112,6,280.8500,18,280.4900,280.5500,12674,1438
MRC,14092,200,7.3400,100,7.3300,7.3400,13459,633
TIMB,14092,100,12.4200,400,12.3900,12.4000,13892,200
ALV,14067,100,90.3100,250,90.0500,90.0600,13707,360
LABU,14063,500,123.5900,100,123.2400,123.5700,12815,1248
CGNX,14056,4,85.3600,100,85.1700,85.3300,13752,304
USIG,14052,300,61.2900,900,61.2800,61.2800,12587,1465
JAMF,14036,100,33.2700,100,33.0500,33.1000,13936,100
KIQ,14028,100,0.7100,100,0.7033,0.7099,12928,1100
MYSZ,14015,100,1.5800,300,1.5200,1.5400,7015,7000
JMBS,14005,300,53.5800,500,53.5400,53.5700,13205,800
BLBD,13997,300,22.3000,100,22.1800,22.2900,13797,200
SEM,13985,78,28.6500,200,28.6100,28.6400,13982,3
VB,13974,200,208.1900,15,208.1200,208.1100,13606,368
BSMX,13973,1500,5.2300,600,5.2100,5.2100,13973,0
PAYA,13972,22,13.9400,100,13.8900,13.9200,13773,199
SINA,13961,600,42.8700,400,42.8000,42.8300,12976,985
DS,13912,3,2.4800,4600,2.4600,2.4800,13412,500
AIR,13908,100,37.1900,100,37.0000,37.0100,13879,29
APOG,13871,5,37.2800,200,37.2000,37.1500,13771,100
NMR,13870,200,5.5400,200,5.5300,5.5400,13770,100
AGR,13866,100,45.8900,195,45.7900,45.8400,13823,43
AGQ,13862,100,48.3700,100,48.3000,48.3500,13162,700
BRO,13854,3,47.5800,300,47.5600,47.5700,13713,141
PNNT,13852,500,5.2100,520,5.1900,5.2000,13551,301
IGC,13827,900,1.5400,728,1.5300,1.5400,13827,0
RGEN,13824,1,218.2600,100,217.0900,218.2400,13754,70
HT,13821,400,7.8600,200,7.8500,7.8800,13515,306
MITK,13821,200,17.3100,100,17.2300,17.2900,13791,30
CAMT,13818,100,24.0900,400,23.8900,23.8600,11828,1990
AVID,13809,100,17.7200,100,17.6200,17.6200,12944,865
SWTX,13804,100,80.7500,100,80.6000,80.7800,13741,63
ATEC,13788,120,14.5400,100,14.5000,14.5200,13785,3
APTX,13776,78,4.0700,36,4.0500,4.0500,13476,300
RRD,13755,100,2.5300,4,2.5200,2.5200,13555,200
CGRO,13729,200,13.5400,100,13.5000,13.5100,13436,293
DX,13727,200,18.7600,200,18.6100,18.7100,10354,3373
LGND,13715,60,135.1400,100,134.3500,135.0100,13600,115
CHRS,13712,134,18.1400,100,18.1000,18.1300,13554,158
CATY,13694,200,35.6800,100,35.6000,35.6500,13593,101
AKR,13672,300,15.0500,300,15.0300,15.0200,12331,1341
LAD,13666,20,334.9000,100,333.1900,333.7300,13326,340
JOE,13650,300,47.2400,200,46.8600,46.9500,12980,670
CCXI,13649,14,63.5000,1,63.3200,63.4800,13185,464
CC,13619,100,27.2800,84,27.1700,27.2600,12419,1200
RUTH,13614,100,19.3800,200,19.2900,19.2900,13613,1
ACAMW,13589,200,2.5800,100,2.3200,2.4400,13389,200
CLBK,13556,200,15.9100,370,15.8800,15.8800,13536,20
ASH,13549,100,87.5400,26,87.3000,87.3200,13543,6
ACND,13523,100,10.5200,200,10.4500,10.5000,2775,10748
CD,13510,300,18.3700,100,18.2500,18.3500,13283,227
ACES,13494,28,97.7500,6,97.6500,97.5000,13326,168
ODFL,13490,24,208.1400,10,207.9400,207.9600,13189,301
KMT,13489,100,39.6300,202,39.5800,39.6000,13389,100
PRIM,13489,100,30.9200,100,30.8300,30.8900,13257,232
SKLZ+,13487,100,17.0000,100,16.4500,16.9500,10223,3264
FUND,13485,2,7.5600,3000,7.5000,7.5500,6755,6730
WAFD,13462,9,28.6300,2,28.5800,28.6200,13303,159
ADPT,13446,100,67.0200,3,66.7100,66.8000,13342,104
NXST,13438,8,109.6700,2,109.5200,109.6400,13433,5
HYFM,13435,100,73.6300,120,72.9600,73.6700,12044,1391
PSTX,13431,100,9.9100,115,9.7800,9.8500,11756,1675
PWR,13416,100,78.0800,66,78.0100,78.0800,13164,252
BLOK,13408,500,38.0100,500,37.8400,37.9250,10402,3006
MLHR,13406,35,36.9500,100,36.7900,36.7900,13405,1
TMST,13402,101,5.3000,100,5.2800,5.2900,13176,226
STSA,13397,200,5.4100,100,5.3700,5.4000,13397,0
PLMR,13394,100,98.0100,5,97.2500,97.5000,13391,3
MNRL,13390,100,13.2500,1,13.2000,13.2600,13290,100
SPFR=,13375,100,11.6900,100,11.5300,11.5800,11375,2000
ONDS,13360,100,13.5500,3,13.3800,13.2100,13280,80
OMF,13359,200,51.5000,5,51.2900,51.3200,13092,267
KNSA,13358,100,17.8000,100,17.7300,17.7800,13158,200
VGZ,13357,300,0.9800,500,0.9641,0.9777,12913,444
NEOG,13348,105,83.8800,100,83.7100,83.8100,13248,100
IRTC,13338,100,255.4900,100,253.4800,254.6000,13153,185
SEIC,13337,100,59.8000,43,59.6800,59.8000,13335,2
TRTX,13336,9,11.2300,100,11.1800,11.2200,13124,212
ATGE,13312,160,39.0900,144,38.9500,38.8700,13206,106
ROAD,13283,100,32.9300,38,32.6000,32.7500,13225,58
ARE,13264,100,171.7000,100,171.6200,171.6500,13072,192
MTC,13262,1400,1.9600,560,1.9100,1.9200,13262,0
BHLB,13245,100,19.0000,600,18.8200,18.9500,13243,2
USAT,13239,200,10.6200,100,10.5700,10.6000,12585,654
SBLK,13224,299,11.1600,100,11.1200,11.1600,13124,100
BLK,13208,1,743.9500,117,743.1700,743.8500,12936,272
SVMK,13171,18,26.2800,13,26.2300,26.2400,13171,0
EVLO,13157,100,13.9200,800,13.5400,13.6900,13057,100
SRC,13155,10,39.6700,300,39.5400,39.6600,12455,700
FNDA,13145,200,46.2500,900,46.2100,46.2100,13145,0
EGAN,13141,98,12.4900,100,12.4200,12.4900,13141,0
KBAL,13133,77,12.6400,89,12.5700,12.6400,12701,432
YYY,13129,100,16.4100,500,16.4000,16.4100,2931,10198
VLDRW,13123,101,8.6900,500,8.6300,8.6600,13123,0
ZG,13108,100,152.8700,1,152.0100,152.2600,12938,170
IBP,13097,2,120.8300,3,120.5100,120.8200,12796,301
MFG,13084,1300,2.7000,500,2.6900,2.6900,13084,0
ITI,13060,800,6.7300,700,6.6800,6.6900,13060,0
TAIL,13054,800,20.1600,485,20.1500,20.1500,13054,0
WCC,13022,100,85.4500,100,85.0300,84.8900,12773,249
BKE,13021,100,33.8300,100,33.7800,33.8100,12938,83
HDGE,13000,27000,2.8400,20802,2.8300,2.8400,13000,0
IPHI,12996,33,178.5500,10,177.9100,177.6200,12896,100
JELD,12995,110,29.2800,95,29.2400,29.2200,12994,1
IGMS,12977,100,94.3100,100,93.2300,93.9600,12828,149
ONCT,12977,188,5.6900,311,5.6700,5.6900,12431,546
UBX,12958,100,6.8800,200,6.8400,6.8800,12744,214
ILPT,12932,143,22.3900,14,22.3500,22.3700,12732,200
UONEK,12926,2400,1.5900,300,1.5600,1.5650,12726,200
HAACU,12925,20,12.9100,100,12.8000,12.8500,12375,550
ASM,12921,2700,1.2000,7,1.1900,1.1950,12921,0
DCOM,12911,200,17.5200,200,17.4400,17.5000,12312,599
TFI,12893,397,52.3600,400,52.3400,52.3600,12893,0
FFIN,12885,153,40.0400,100,39.9000,40.0000,12560,325
FCPT,12883,100,27.7000,500,27.4500,27.5500,12881,2
IVE,12881,900,131.4600,900,131.4200,131.4200,12581,300
AMTX,12864,100,4.0300,100,4.0000,4.0200,12364,500
CTRA,12855,100,14.0300,100,13.7300,13.8700,7940,4915
HEDJ,12831,500,68.4500,100,68.4200,68.4000,9751,3080
BTAI,12817,100,48.5700,27,48.2900,48.3800,12770,47
EXPO,12805,4,92.6900,100,92.6200,92.6300,12799,6
EVTC,12793,200,38.3600,1,38.3300,38.3500,12791,2
NOC,12778,4,297.9000,18,297.5700,297.6400,12004,774
FIVE,12749,100,189.5300,26,188.8400,189.0000,12477,272
HTLD,12747,100,19.5900,100,19.5500,19.5500,12746,1
GOSS,12743,1100,10.2700,200,10.2000,10.2300,12676,67
SPHB,12743,400,60.9300,100,60.9200,60.9200,11843,900
BDC,12729,5,47.5200,300,47.4600,47.5100,12729,0
LEVI,12707,200,21.0700,100,21.0300,21.0400,10543,2164
GMIIU,12691,100,11.3200,100,11.2600,11.3100,12026,665
OFC,12687,3,26.1500,224,26.1200,26.1600,12666,21
VOYA,12680,200,58.7000,1,58.6800,58.7100,12462,218
TLMD,12676,100,7.4300,356,7.4000,7.4200,12394,282
KTB,12654,10,42.1700,200,42.0500,42.1600,11225,1429
WERN,12596,100,42.7200,6,42.6400,42.6700,12565,31
ICF,12581,500,53.8600,2300,53.8400,53.8900,12578,3
HERO,12579,300,33.4000,300,33.3500,33.3800,2264,10315
SGMS,12569,14,44.6800,100,44.6000,44.6100,12347,222
BRP,12568,20,27.0700,100,26.9500,27.0000,12392,176
GLDD,12562,600,14.1000,100,14.0500,14.0700,12562,0
EBR.B,12554,900,5.8800,1100,5.8500,5.8800,12354,200
HUGE,12546,200,2.2400,754,2.2100,2.2300,11460,1086
EVV,12542,2,12.4800,200,12.4700,12.4700,12470,72
CGEM,12541,100,38.1000,100,37.6600,37.9600,5184,7357
AAT,12536,100,29.2200,100,29.0700,29.1000,12435,101
SYNA,12534,32,107.0000,100,106.3200,106.3400,12132,402
TUR,12534,79,28.2400,300,28.1000,28.2100,11234,1300
TRUP,12529,100,116.6600,100,116.0000,115.8400,12529,0
RETA,12527,200,111.3100,100,110.3900,110.6000,12279,248
SRG,12527,87,15.1400,1,15.0600,15.0400,12166,361
ACM,12516,100,53.8700,57,53.7100,53.8000,10084,2432
SWAV,12512,1,131.6600,2,131.5500,131.6100,12500,12
AIMC,12504,1,57.3100,200,57.1600,57.2000,12174,330
TMQ,12501,400,2.0400,1400,2.0200,2.0300,12401,100
PVAC,12489,100,11.3800,200,11.3100,11.3300,12068,421
DMYI,12473,200,11.5600,300,11.5300,11.5500,12339,134
MSI,12465,10,172.5900,3,172.5500,172.5500,12404,61
REMX,12465,191,82.3900,200,82.2000,82.3700,3519,8946
NGM,12457,100,27.7500,1,27.5700,27.5700,12014,443
CLI,12452,200,13.5100,300,13.4400,13.4600,12351,101
PIRS,12450,400,2.7600,333,2.7500,2.7550,12250,200
ACY,12441,201,8.4000,100,8.2900,8.3500,12441,0
TEX,12435,2,38.7000,1,38.6300,38.7000,12417,18
INMD,12432,100,59.9100,100,59.3500,59.6800,11850,582
PAWZ,12427,400,74.5800,26,74.4600,74.5200,11927,500
CMD,12426,2,80.2900,100,80.1000,80.2550,12426,0
AAOI,12425,100,10.6000,100,10.5500,10.5400,11824,601
BANC,12422,110,17.6900,100,17.5600,17.6700,12381,41
CDLX,12420,100,122.4100,1,121.5700,121.6300,12116,304
ARKO,12397,100,8.1700,100,8.1100,8.1300,11660,737
MTW,12396,1,14.8100,100,14.7900,14.8000,12296,100
COHU,12394,35,48.4300,100,48.1500,48.2500,12369,25
GOEVW,12370,100,4.9400,100,4.8300,4.8700,9177,3193
NEW,12369,200,6.5700,300,6.5500,6.5600,12369,0
ITRI,12366,100,96.9300,5,96.6400,96.6500,12243,123
BLD,12357,100,216.7200,12,216.3400,216.6800,12257,100
POWI,12356,100,93.0900,100,92.8200,93.0100,12255,101
EAR,12353,100,57.5300,100,57.0300,57.5300,12149,204
IDCC,12350,105,68.2000,2,68.1300,68.1700,12350,0
KBNT,12342,100,5.5200,1,5.4500,5.4750,12307,35
RIBT,12341,2200,0.8540,100,0.8201,0.8400,12341,0
PFMT,12339,1400,1.2800,20,1.2500,1.2600,12339,0
REVG,12326,200,11.8100,202,11.7600,11.7300,11703,623
PHK,12312,700,6.0700,290,6.0600,6.0600,12312,0
ICAD,12309,168,14.9900,100,14.8800,14.9400,10609,1700
KNGS,12298,498,27.3200,1100,27.1200,27.2600,10833,1465
CLS,12295,300,8.9400,100,8.9200,8.9300,10159,2136
GSG,12284,3100,12.9900,600,12.9800,12.9800,11884,400
YAC,12276,700,10.5700,100,10.4700,10.5300,2800,9476
BRMK,12272,100,10.6700,120,10.6500,10.6500,12206,66
CSOD,12272,200,43.3100,12,43.1900,43.2800,12214,58
EMLP,12266,100,22.2100,2900,22.2000,22.1900,12266,0
DTE,12247,1,122.6800,50,122.6500,122.6500,12024,223
ALT,12240,100,12.9900,1000,12.8700,12.9400,12139,101
MAA,12234,100,133.3200,10,133.2100,133.1900,12230,4
ANGO,12223,100,18.8000,200,18.6600,18.7000,12049,174
HEI.A,12216,73,114.4300,54,114.0500,114.3550,12216,0
IAC,12215,1,204.9000,100,204.4300,204.5400,11985,230
TRU,12213,4,92.8300,100,92.7400,92.8600,11717,496
SIMO,12207,200,51.3000,211,51.0800,51.1200,12189,18
CMTL,12193,100,22.6700,100,22.5300,22.5300,12193,0
GVA,12187,100,33.2900,100,33.1000,33.2300,12134,53
UFS,12185,204,32.9800,111,32.9500,33.0000,12084,101
TXT,12182,100,49.3700,100,49.3200,49.3400,11984,198
MCS,12176,100,15.9600,100,15.8600,15.9300,12105,71
SOAC,12155,1000,11.3700,100,11.2700,11.3000,12147,8
TPTX,12146,100,130.8000,100,129.6400,130.0100,12128,18
FXO,12140,1300,36.7400,700,36.7300,36.7400,11440,700
PHIO,12136,100,3.1400,100,3.0800,3.1100,5936,6200
GHIVW,12135,100,2.7800,100,2.7000,2.6900,12135,0
CBZ,12114,100,27.5000,100,27.4300,27.4100,12019,95
PRDO,12110,100,12.8200,200,12.7700,12.7900,12047,63
AMP,12109,3,213.3500,2,213.2800,213.4000,11869,240
LJPC,12096,100,5.5500,1900,5.4800,5.5300,11896,200
EVRG,12088,100,53.6500,200,53.5500,53.6000,11855,233
BPMC,12056,4,100.9500,100,100.5200,100.7800,11938,118
ISUN,12055,600,22.3900,400,22.1400,22.1900,10480,1575
MBII,12048,700,1.6000,300,1.5700,1.5900,12048,0
PLT,12040,100,32.7400,4,32.7000,32.6900,12040,0
CHIQ,12036,600,39.6100,300,39.5200,39.5650,11336,700
BGFV,12021,100,12.2000,109,12.1100,12.1300,10966,1055
PTCT,12010,34,62.9800,1,62.6100,62.7000,11922,88
NSA,12006,3,36.3100,5,36.2400,36.2700,11805,201
BREZW,12005,200,1.4000,100,1.3000,1.3300,11705,300
CNSL,11987,22,5.5900,506,5.5700,5.5800,11787,200
RJF,11987,101,102.6800,152,102.6000,102.6800,11875,112
JKHY,11983,2,153.8200,7,153.7500,153.8100,11045,938
DSX,11964,1500,2.4600,1800,2.4100,2.4400,11764,200
CAE,11962,100,23.9800,100,23.9600,23.9800,11093,869
UNVR,11957,114,20.1400,115,20.1200,20.1200,11954,3
GNACU,11944,100,10.6200,100,10.5500,10.5800,11944,0
FLL,11935,400,5.1200,100,5.0800,5.0300,11935,0
HIBB,11935,100,54.4900,100,54.0900,54.2000,11872,63
HLF,11929,200,50.5700,100,50.5100,50.5400,11657,272
AVCO,11924,260,1.1900,400,1.1700,1.1800,9823,2101
EYE,11924,18,49.8100,5,49.5800,49.6300,11844,80
MGC,11912,200,137.1200,400,137.0900,137.0700,11912,0
WUGI,11910,1000,56.0200,53,55.9300,55.9800,11910,0
IMV,11900,100,3.5600,100,3.5400,3.5400,9200,2700
HSC,11887,149,17.7900,100,17.7300,17.7400,11885,2
PTLC,11880,200,33.6500,900,33.6300,33.6300,11880,0
MSN,11854,300,1.1900,100,1.1800,1.1850,10757,1097
QRTEP,11847,100,100.6200,100,99.7900,100.1200,9347,2500
BKYI,11838,100,4.2200,100,4.1900,4.2000,11666,172
ADV,11813,100,11.4900,100,11.4600,11.4600,11710,103
GOED,11803,200,9.1900,100,9.1100,9.0700,10909,894
VNQI,11795,500,54.2400,800,54.1600,54.1900,11783,12
PI,11793,100,61.2500,100,60.8500,61.0000,11261,532
IPDN,11776,100,2.5000,200,2.4100,2.4500,11776,0
SAGE,11775,4,92.9200,100,92.7800,92.8500,11775,0
NBRV,11770,900,2.9800,7,2.9500,2.9700,11470,300
MRTX,11762,7,213.1500,100,212.1000,212.6800,11735,27
COWN,11761,100,27.8500,400,27.6800,27.8500,11684,77
MONCU,11738,100,10.3800,200,10.3300,10.3300,11738,0
ADERU,11718,100,10.6900,100,10.6400,10.6900,7264,4454
RYAAY,11711,100,104.7500,100,104.5700,104.6800,11644,67
DOV,11709,200,125.5600,1,125.4500,125.4600,11415,294
FMIL,11705,100,25.4000,7800,25.3500,25.3700,11705,0
VIVO,11702,400,22.6700,100,22.5400,22.5600,11218,484
COOLU,11700,100,10.7300,100,10.6600,10.7000,11700,0
AWH,11689,1700,5.9900,597,5.9000,5.9200,11489,200
NDLS,11684,700,8.9800,100,8.9200,8.9200,11365,319
ABMD,11683,20,350.5700,100,349.9900,350.1900,11610,73
XENT,11680,100,26.8100,321,26.6500,26.6100,11268,412
LRN,11676,100,24.9500,100,24.7300,24.8200,11576,100
ALC,11675,6,73.4400,100,73.3100,73.3900,10167,1508
SY,11670,100,12.1200,144,12.0700,12.0900,11670,0
BIZD,11666,467,14.4400,100,14.4200,14.4350,8366,3300
TREX,11640,100,95.5300,100,95.4000,95.4700,9925,1715
HAAC,11632,200,12.3900,100,12.2100,12.2500,11477,155
MCFE,11614,159,19.2700,200,19.1500,19.1700,11514,100
FLTR,11601,100,25.3700,700,25.3600,25.3600,2201,9400
ESTC,11595,100,173.1400,7,172.0200,172.2600,11431,164
CASH,11592,36,38.9100,1,38.6900,38.7400,11485,107
RYI,11582,100,14.2300,100,14.0900,14.1200,11291,291
KOF,11571,64,46.5700,200,46.5300,46.5300,11571,0
LSXMK,11569,200,41.1400,1,40.9800,40.9800,10881,688
SLCRU,11557,200,10.4800,93,10.4100,10.4000,10033,1524
MMS,11549,100,75.8400,200,75.7400,75.7500,11453,96
RVNC,11542,100,28.6800,100,28.5600,28.6600,11058,484
WTRE,11538,106,34.6700,25,34.6600,34.6600,11538,0
MTSI,11529,100,62.3900,100,62.2900,62.3500,11050,479
BKU,11507,100,37.4100,300,37.1300,37.2700,11506,1
SNDR,11496,100,23.3600,100,23.3100,23.3300,11489,7
HGEN,11495,9,18.8000,100,18.6100,18.7500,10575,920
BDJ,11494,900,8.6200,1300,8.6100,8.6100,11494,0
CQQQ,11485,400,96.7900,100,96.4500,96.4850,5716,5769
MTH,11475,100,92.5600,200,92.4900,92.4900,11388,87
FDEC,11450,500,31.1000,4000,31.0500,31.0700,11450,0
CIK,11442,1000,3.1600,2300,3.1500,3.1550,11442,0
CVBF,11441,100,21.0400,162,20.9800,21.0300,11427,14
HAFC,11438,100,12.4600,100,12.3700,12.4000,11337,101
GLBS,11437,1,7.0900,100,7.0300,7.0100,11337,100
DDM,11431,300,58.8700,600,58.8500,58.9300,11281,150
RMD,11400,100,216.3900,78,216.2300,216.2100,10824,576
CNSP,11381,100,2.0400,100,2.0200,2.0100,10881,500
ACTCW,11373,200,8.7300,16,8.6000,8.7400,10173,1200
HNGR,11369,100,22.6800,400,22.4100,22.6000,11338,31
ERES,11366,100,10.5100,100,10.4400,10.4600,11366,0
YOLO,11364,200,22.0600,400,21.9300,22.0000,5968,5396
TLYS,11356,300,10.1300,295,10.0500,10.0800,11056,300
ELYS,11349,100,5.8300,100,5.7100,5.7050,9355,1994
GTH,11325,100,21.4300,100,21.0300,21.2150,11225,100
SR,11307,117,61.3200,200,61.2400,61.2600,11212,95
TACA=,11300,100,11.1700,100,10.9600,10.9900,9800,1500
FREL,11291,500,25.5600,2800,25.5500,25.5500,10891,400
AVAN,11289,100,11.0700,100,11.0300,11.0300,10989,300
MLM,11253,100,309.0000,10,308.5000,309.1000,10801,452
URI,11232,3,261.2400,100,260.9600,261.2300,10321,911
RXT,11228,300,19.2000,8,19.1300,19.1800,11028,200
PRAA,11225,100,34.9200,100,34.7400,34.7850,11224,1
GBX,11222,300,36.6000,1,36.3800,36.3800,10985,237
KSA,11199,300,31.8100,300,31.7800,31.8000,11195,4
CYCN,11190,200,3.3500,200,3.3300,3.3400,11190,0
PAHC,11185,45,21.3600,7,21.2700,21.2800,11184,1
MNRO,11179,2,58.2300,100,58.1100,58.2100,11171,8
SEAH=,11150,500,11.3900,900,11.3300,11.3400,11150,0
CCK,11147,25,95.2700,1,95.0400,95.0400,11062,85
TCON,11146,100,10.2300,200,10.1800,10.2300,11006,140
AMN,11126,200,73.9900,100,73.8300,73.9000,11108,18
CTAS,11101,15,332.1800,8,331.8600,331.8700,10761,340
CWEN.A,11087,100,32.7000,25,32.4900,32.5400,11087,0
BDGE,11077,100,26.9200,100,26.8400,26.8800,10987,90
WRB,11073,79,66.9000,1,66.8500,66.8500,10956,117
FBIO,11066,300,3.4700,100,3.4600,3.4700,8566,2500
PANA,11063,100,11.2800,300,11.1300,11.2200,11063,0
ARLP,11042,100,5.2900,400,5.2700,5.2900,10759,283
AZO,11032,221,1249.9300,100,1248.9300,1249.3100,11027,5
SUSL,11030,300,66.7400,300,66.7200,66.7100,11030,0
RWX,11029,100,33.6700,600,33.6600,33.6600,11018,11
SAII,11014,100,10.6400,100,10.5700,10.6000,10514,500
MASS,11011,100,63.4900,100,62.6700,62.8400,10725,286
ATSG,10983,10,27.4300,200,27.3800,27.4100,10983,0
SCHX,10981,800,93.8100,500,93.7900,93.7700,10881,100
AMBC,10953,200,15.6700,100,15.5800,15.5900,10952,1
CTRE,10938,100,22.7200,100,22.7000,22.7000,10597,341
NLTX,10936,3,13.1500,1,13.0500,13.0700,10936,0
HSIC,10923,275,68.6800,13,68.6100,68.6300,10626,297
SANM,10921,100,34.4200,215,34.3600,34.3500,10920,1
MGNX,10915,100,22.7000,500,22.4500,22.5400,9678,1237
SUMO,10911,140,30.6600,3,30.5000,30.5500,10811,100
ROK,10909,100,267.9100,100,267.5700,267.7600,10653,256
AVNT,10894,55,41.7600,15,41.6700,41.6000,10894,0
YANG,10892,1200,11.1100,1700,11.1000,11.1100,10092,800
FOE,10880,182,15.1400,100,15.1000,15.0600,10877,3
FIII,10875,100,12.7700,50,12.6900,12.7300,10675,200
FTIV,10860,200,12.0200,100,11.9500,12.0100,10660,200
AVD,10847,200,18.0400,200,17.9800,18.0000,10746,101
EQIX,10847,100,719.7700,300,718.6400,718.7800,10842,5
GKOS,10832,100,89.7300,16,89.2700,89.2800,10699,133
BREZ,10818,100,10.4000,100,10.3900,10.4000,10818,0
AESE,10814,2600,1.7500,900,1.7300,1.7400,10545,269
ICPT,10813,100,28.3800,100,28.3200,28.3300,10579,234
PSACU,10802,500,13.6000,900,13.5000,13.5500,10602,200
ROP,10802,13,422.9200,13,422.2700,422.6600,10709,93
WST,10802,100,300.0000,1,299.8600,299.8800,9536,1266
SCPL,10787,100,17.2000,413,17.0800,17.0700,10786,1
CAL,10780,100,16.9800,100,16.8200,16.9000,10673,107
PNTM=,10779,100,10.5500,100,10.5000,10.5000,10779,0
PSK,10778,400,43.6600,100,43.6300,43.6400,9778,1000
DRTT,10772,500,2.2900,200,2.2700,2.2700,10377,395
AME,10767,100,119.8100,149,119.7100,119.7700,10354,413
CTLT,10736,100,118.9600,100,118.8300,118.8700,10161,575
SUPV,10734,299,1.8400,1998,1.8200,1.8300,10634,100
ATNX,10733,100,11.5500,71,11.5000,11.5400,9884,849
CTB,10729,100,40.6000,70,40.5600,40.5600,10618,111
GLDG,10724,400,1.9300,2200,1.9200,1.9300,10324,400
MSP,10710,200,26.6000,50,26.5700,26.5700,10214,496
SLAB,10706,2,142.3700,72,142.1300,142.2300,10604,102
UBA,10706,700,14.4100,106,14.3200,14.3400,9400,1306
GSAH=,10700,400,13.1100,900,12.9200,12.9500,10100,600
NVMZ,10700,1000,28.2800,1000,28.1800,28.2500,3000,7700
OSPN,10694,100,24.3600,300,24.3100,24.3700,10353,341
VAW,10684,200,162.6500,100,162.6000,162.5000,10684,0
HTOOW,10682,100,10.4400,100,10.2100,10.6700,10443,239
OXBR,10673,100,2.3100,300,2.2800,2.3000,10673,0
SAH,10667,100,48.6600,100,48.4200,48.4200,10666,1
TKR,10638,13,84.7200,4,84.6500,84.7600,10446,192
HARP,10635,100,22.3900,355,22.2000,22.1900,10455,180
IGR,10632,431,6.9200,400,6.9100,6.9100,10632,0
WRAP,10626,200,5.0800,100,5.0600,5.0600,9870,756
BSCO,10624,1000,22.3500,1100,22.3400,22.3400,10384,240
GDDY,10605,4,83.6100,100,83.5000,83.6400,10076,529
AFIB,10603,141,26.0000,100,25.8200,25.9900,10536,67
LESL,10599,52,28.7900,71,28.5900,28.6300,10326,273
IJK,10586,148,77.6700,100,77.6300,77.6600,10586,0
TRIB,10569,259,4.5400,100,4.4900,4.5300,9169,1400
HMI,10565,100,15.0600,200,14.9600,15.0000,10314,251
NICE,10555,100,274.1400,100,272.0900,273.2200,10157,398
BIV,10514,1100,92.1100,700,92.1000,92.1100,10514,0
CORT,10511,100,28.1800,100,28.0700,28.1500,10319,192
ABM,10507,100,39.1700,36,39.1400,39.1400,10428,79
CTIB,10500,300,2.0200,1300,1.9800,2.0050,9888,612
FIX,10477,100,58.3500,100,58.2100,58.3500,10430,47
SITE,10477,4,172.7600,10,172.3500,172.7600,10277,200
EXTN,10456,100,4.9100,200,4.8800,4.8600,10455,1
APTS,10441,145,7.5900,400,7.5600,7.5800,10441,0
ROM,10428,100,77.4300,200,77.3900,77.4100,10428,0
RGLD,10409,12,105.4900,34,104.9400,105.4000,9355,1054
ALEC,10408,1,16.5000,104,16.4200,16.5000,10308,100
BMI,10398,87,96.9800,101,96.8800,96.8000,10360,38
FTCS,10398,600,67.9800,600,67.9700,67.9600,10098,300
FUSE=,10398,400,13.8000,400,13.6300,13.8500,9998,400
ETTX,10394,200,3.0800,2000,3.0200,3.0300,10244,150
CORR,10389,100,8.0400,100,7.9900,8.0100,10140,249
CBB,10384,558,15.2600,500,15.2500,15.2600,9790,594
HEI,10365,100,132.6300,8,132.5400,132.6000,9406,959
SHYF,10362,1,31.7700,100,31.6600,31.7400,10262,100
AMG,10354,2,113.3100,121,112.9200,113.2600,9123,1231
CLA,10344,39,13.2300,12,13.1800,13.2100,10344,0
CAAP,10343,900,3.9300,100,3.8400,3.9000,10329,14
IWB,10337,1280,218.5600,840,218.4900,218.5000,10277,60
GO,10322,8,38.9600,40,38.8900,38.9400,10243,79
FIZZ,10311,1,95.4400,100,95.1800,95.3800,10202,109
ALGM,10309,500,34.1900,100,33.7800,34.0000,9906,403
PZZA,10304,2,96.6000,45,96.1400,96.2600,10302,2
NX,10297,100,25.1900,200,25.1600,25.1800,10273,24
PRPO,10296,500,2.5100,300,2.4700,2.4900,10097,199
CLM,10284,700,12.4500,558,12.4400,12.4350,9916,368
TOWN,10268,100,24.9600,71,24.9200,24.9500,10267,1
LIVN,10257,100,66.0200,100,65.9100,65.9300,10063,194
KRNY,10252,2,10.8100,71,10.8000,10.8000,10152,100
ZNTL,10242,100,43.8100,100,43.2200,43.5200,10026,216
BV,10238,3,15.9400,200,15.8300,15.8800,9761,477
KRKR,10235,100,5.2400,100,5.1300,5.2000,8335,1900
ALLK,10232,1,129.3400,208,129.0200,129.0700,9956,276
ANET,10224,44,310.7900,100,310.6400,310.7400,9749,475
CSGS,10194,1,45.3500,100,45.0700,45.3000,10194,0
SEAH,10180,100,10.5200,199,10.5000,10.5100,10180,0
SIFY,10179,200,2.3000,30,2.2900,2.3000,9976,203
RAMP,10177,200,82.9100,15,82.4300,82.4200,9676,501
GMBL,10141,100,7.5500,500,7.4000,7.4100,9841,300
GOVX,10130,100,5.0300,100,4.9500,4.9600,10130,0
PRPL,10128,100,35.6800,61,35.5900,35.6500,10028,100
RH,10112,2,506.2500,101,505.4200,506.0400,9992,120
IGAC,10105,100,10.6800,100,10.6100,10.6500,9434,671
ACMR,10100,9,98.9900,200,97.8200,98.6300,9786,314
GLTO,10100,100,12.2400,100,12.0800,12.3900,10100,0
EDZ,10094,1000,7.9400,200,7.9300,7.9400,10094,0
REED,10094,100,0.8099,300,0.8007,0.8010,9339,755
CAJ,10070,300,21.2800,100,21.2700,21.2800,9480,590
GNL,10049,100,17.0100,300,16.9500,16.9500,9997,52
SUSC,10043,1300,28.0000,1491,27.9900,27.9900,10043,0
TNDM,10037,1,94.7400,17,94.2600,94.7300,9255,782
CASS,10031,2,40.3500,1,40.1500,40.1600,10031,0
HY,10022,100,83.0700,100,82.5200,82.9900,9334,688
JPC,10022,900,9.2100,100,9.1600,9.2050,9847,175
ANAB,10005,4,25.3600,100,25.2700,25.2600,9880,125
TBLTW,10000,200,0.5700,200,0.5300,0.5000,900,9100
PCH,9998,1,51.7800,100,51.7400,51.7800,9793,205
NTGR,9995,100,38.8000,200,38.6400,38.7600,9833,162
BPMP,9992,100,12.3000,100,12.2400,12.2000,9416,576
WOW,9989,100,11.1800,200,11.1200,11.1300,9543,446
APAM,9983,100,53.8700,79,53.6300,53.6600,9980,3
GNRS,9981,100,10.5600,100,10.4800,10.5000,4876,5105
CBIO,9978,1000,6.7400,100,6.6700,6.7000,9578,400
SREV,9968,300,1.5300,3005,1.5000,1.5300,8014,1954
JHG,9956,1,34.1500,300,34.0400,34.1900,9852,104
MOD,9952,1,14.2100,100,14.1400,14.2000,9899,53
DAO,9948,100,32.4700,100,32.1800,32.3000,9778,170
FMB,9943,100,56.7600,300,56.7500,56.7550,9943,0
TRS,9937,100,33.7700,100,33.4800,33.6500,9410,527
SYBX,9929,100,4.2400,30,4.1800,4.2100,9642,287
MNOV,9926,400,5.8600,800,5.7900,5.8600,9926,0
MGU,9921,42,20.5900,100,20.4400,20.5900,9701,220
CPT,9900,5,102.4900,100,102.1500,102.5000,9799,101
CDW,9896,1,137.1800,100,137.0800,137.1400,9517,379
TVTX,9894,100,27.1500,46,26.9900,27.0000,9698,196
NNVC,9884,100,3.7800,100,3.6700,3.7400,8901,983
AUB,9853,100,35.9200,30,35.8400,35.9600,9839,14
POTX,9849,100,15.1700,300,15.1100,15.1250,9449,400
NTCT,9846,200,30.0200,143,29.9700,29.9700,9846,0
VPU,9846,200,137.8700,100,137.8400,137.8400,9846,0
ZUMZ,9845,100,43.5100,1,43.1600,43.2300,9802,43
SRET,9842,800,9.0500,9900,9.0300,9.0400,8341,1501
LAZ,9839,200,43.7100,200,43.3900,43.5500,9458,381
CORE,9827,13,33.4600,100,33.3700,33.4200,9824,3
IUSV,9825,100,63.9500,1300,63.9400,63.9500,6225,3600
DVYE,9824,300,38.6600,600,38.5800,38.6500,9482,342
PII,9822,100,118.1600,100,117.7300,117.7900,9621,201
MGP,9816,11,31.7700,200,31.7200,31.7600,8760,1056
HROW,9806,100,8.5300,100,8.4600,8.4800,7306,2500
THS,9803,106,39.9100,3,39.8700,39.8900,9709,94
ALTR,9790,1,61.7800,122,61.4100,61.7200,9390,400
UKOMW,9788,100,0.2600,100,0.1700,0.2200,9788,0
BR,9780,100,151.2400,100,151.1000,151.1100,9665,115
IBTJ,9779,33800,25.9000,33800,25.8800,25.9000,9779,0
XBIT,9767,25,17.0500,29,17.0000,17.0000,9042,725
XCUR,9756,400,2.3300,1900,2.2900,2.3100,9756,0
UK,9730,100,5.0900,100,4.9500,4.9900,9730,0
FLT,9724,5,271.1800,1,270.9700,271.1600,9423,301
AVIR,9718,100,55.6900,100,54.3300,55.4000,9548,170
VRSN,9718,14,197.7400,100,197.5900,197.6500,8178,1540
NVRO,9714,3,181.0400,100,180.1400,180.9050,8928,786
DFHT,9696,100,16.0600,100,15.9600,15.9600,8771,925
LFUS,9679,100,279.2500,2,278.5500,279.1000,9446,233
CTSO,9677,100,9.2700,100,9.2000,9.2600,9575,102
MBI,9673,100,6.7900,600,6.7700,6.7900,9673,0
HBANO,9662,100,25.3900,100,25.3700,25.3900,9662,0
LEA,9662,1,168.6700,100,167.9800,168.5300,9268,394
ICHR,9657,100,40.9500,100,40.8500,40.9500,9610,47
MBUU,9646,1,76.3300,100,75.9800,76.2100,9482,164
ANSS,9626,1,372.8300,100,372.5500,372.7300,9522,104
ONTO,9613,6,57.3300,100,56.9700,57.4200,9592,21
MXL,9610,400,36.0800,100,35.8200,35.8400,9609,1
DEA,9609,74,23.2600,100,23.2000,23.2100,9366,243
SC,9605,100,23.3200,6,23.2800,23.3000,9352,253
WWW,9602,1,30.9700,14,30.9400,30.9500,9433,169
BSJL,9566,109,23.0800,500,23.0700,23.0700,8966,600
DIV,9565,750,17.7700,200,17.7500,17.7500,5068,4497
NRGX,9561,200,8.9600,100,8.9200,8.9500,9261,300
WLK,9557,1,84.2400,139,83.7100,84.0200,9427,130
FFIV,9552,25,200.4900,100,200.1600,200.2400,9358,194
IBOC,9541,56,42.0500,200,41.8600,41.9100,9355,186
SGEN,9533,100,185.7300,100,185.4600,185.5500,9342,191
TOTL,9532,600,49.2800,600,49.2700,49.2700,9332,200
BBUS,9528,3200,70.9000,300,70.8700,70.8500,9528,0
PCI,9517,100,21.3300,100,21.1600,21.2200,9417,100
RKDA,9511,63,3.0700,1600,3.0300,3.0700,9511,0
ACOR,9505,15,7.2700,9,7.2300,7.2600,9081,424
THM,9495,300,1.3400,1011,1.3200,1.3300,9495,0
CBSH,9491,105,68.4800,100,68.2900,68.5900,9484,7
SUN,9479,400,31.1100,58,30.8300,30.9300,9164,315
BJRI,9463,100,46.7400,100,46.2000,46.6400,9263,200
HOTH,9463,100,2.2300,100,2.2200,2.2250,9463,0
KTRA,9457,100,1.8300,1300,1.7900,1.8200,9257,200
FMAC,9455,100,10.9900,100,10.9400,10.9500,9355,100
AEY,9440,700,3.1600,200,3.0900,3.1400,9247,193
CONXU,9435,100,10.9700,100,10.9100,10.9200,9435,0
ORLY,9433,11,471.9800,63,471.4300,471.8200,9263,170
DECK,9427,100,326.0000,100,323.6500,325.3100,9323,104
MC,9424,7,54.3900,150,54.3400,54.3800,9367,57
VTEB,9419,603,55.1700,320,55.1600,55.1650,9419,0
SPRQ=,9412,100,12.6900,900,12.5700,12.5100,9312,100
FTDR,9411,100,55.6900,1,55.5100,55.6100,8943,468
GNPK,9409,100,10.7000,100,10.6100,10.6500,9409,0
PLYM,9409,100,15.1500,6,15.0600,15.0850,8894,515
SWX,9396,100,57.7900,100,57.4600,57.6400,9395,1
NWE,9389,10,56.0600,446,55.9800,55.9500,9378,11
GOAC,9385,200,10.4600,100,10.4000,10.4400,8885,500
RFP,9375,100,8.3800,100,8.3300,8.3400,8952,423
ABCB,9361,100,43.4400,200,43.1600,43.2300,9257,104
PAYS,9360,100,5.0500,100,5.0300,5.0500,9360,0
SRRK,9352,300,53.0000,100,52.2600,52.4500,9347,5
LSXMA,9346,100,41.1400,100,41.0100,40.9800,9275,71
IBMM,9345,380,27.0800,7600,27.0600,27.0700,9345,0
HBNC,9334,55,16.8900,100,16.7800,16.8400,9334,0
WTRG,9331,11,46.1700,100,46.0600,46.1700,9197,134
SMED,9323,100,12.2200,100,12.1100,12.1400,9323,0
MODN,9319,1,38.5900,100,38.4400,38.5500,9319,0
PFC,9318,7,26.4700,177,26.2300,26.4300,9318,0
BCX,9317,100,8.3300,201,8.2500,8.2900,9117,200
BW,9316,100,5.7800,100,5.7500,5.7700,9073,243
DHX,9316,114,2.4200,400,2.3800,2.4200,9316,0
EFR,9295,400,13.5500,100,13.4600,13.5300,9295,0
DEO,9290,200,160.6900,21,160.5600,160.6200,9189,101
PBH,9274,100,38.2200,100,37.9100,38.0900,9273,1
SGRY,9251,100,31.2000,100,30.9400,31.2700,8530,721
CVAC,9244,46,102.3800,100,100.8900,101.6800,8086,1158
GGG,9234,100,76.2900,4,76.2500,76.3100,8387,847
PBYI,9231,112,10.6200,100,10.5500,10.5900,9131,100
FRT,9226,100,87.1000,100,86.9700,87.0800,8640,586
TFC-O,9222,100,27.6700,100,27.3900,27.5000,8679,543
QK,9220,100,2.6400,100,2.5200,2.5900,9020,200
BRKR,9218,100,61.3400,100,60.9200,61.1300,9218,0
WCLD,9214,200,55.8700,500,55.7900,55.8500,9213,1
EDAP,9211,100,8.1700,100,8.0900,8.1000,7608,1603
IART,9208,39,69.8600,100,69.5100,69.5900,9035,173
STAR,9207,100,15.5100,200,15.4900,15.4950,8041,1166
AMRC,9202,152,59.8300,100,59.4700,59.5800,9101,101
CIO,9201,25,9.6900,300,9.6700,9.6800,7808,1393
SHW,9201,100,737.6000,100,736.4800,736.9500,9195,6
ARGO,9199,100,44.6200,4,44.4700,44.5400,9199,0
CLVRW,9190,100,2.2200,100,2.1200,2.0700,9190,0
COGT,9175,120,11.9900,40,11.9100,11.9900,8982,193
MRCY,9170,100,79.4600,3,79.3400,79.3700,8969,201
ARAV,9162,100,5.8100,100,5.7200,5.7500,8879,283
PVH,9162,100,99.5800,10,99.4700,99.4700,9059,103
ASTE,9161,100,66.6700,218,66.3500,66.5400,9024,137
OPRX,9161,100,43.2400,1,42.9800,43.2300,9100,61
BSCQ,9147,3100,21.8100,100,21.7900,21.8000,8847,300
SNN,9147,1,44.8500,95,44.8100,44.8000,8947,200
LCYAU,9142,400,11.4000,900,11.0700,11.1300,9042,100
SNPR,9139,200,12.8000,200,12.7200,12.7600,9132,7
BCOR,9130,15,17.2000,100,17.1600,17.1700,9129,1
MP+,9129,100,20.1400,100,19.9500,20.0600,8575,554
ETACW,9125,100,2.3300,100,2.2000,2.3000,7900,1225
VRP,9123,500,25.9700,600,25.9100,25.9500,9123,0
NCV,9114,600,5.7900,433,5.7800,5.7850,9003,111
PFGC,9109,100,51.8200,100,51.3800,51.5500,9109,0
GATX,9087,100,88.7100,100,88.2600,88.3000,9009,78
VTIQU,9079,100,11.6700,100,11.5500,11.6000,9046,33
FOUR,9076,100,70.7500,100,70.4000,70.5200,8808,268
DON,9063,200,36.7000,200,36.6900,36.7000,6721,2342
ARGX,9061,20,313.7500,100,311.6900,313.5200,8678,383
GRBK,9059,100,23.5000,300,23.3800,23.4900,8959,100
MOG.A,9057,100,76.8300,100,76.2100,76.3700,9055,2
OEC,9052,100,16.5900,100,16.5000,16.5000,8870,182
ONE,9052,100,3.9900,100,3.9400,3.9800,7952,1100
HII,9046,105,167.4700,31,167.2800,167.3500,7879,1167
QTWO,9037,1,136.8500,100,136.4600,136.9100,8452,585
TCS,9029,100,12.5500,100,12.4000,12.4900,7927,1102
OMCL,9028,100,121.7900,1,121.2100,121.2700,8957,71
NUS,9023,57,58.1600,146,57.8900,57.8500,8560,463
ATKR,9018,11,48.3200,100,48.1800,48.2700,8971,47
SNBR,9007,1,97.8500,100,97.6500,97.6200,8831,176
DVA,9005,100,119.5600,100,119.4500,119.5500,8612,393
HEP,8994,100,14.7800,100,14.7400,14.7600,8952,42
MET-F,8979,100,25.9000,100,25.7500,25.8500,6979,2000
AGS,8968,100,5.9200,376,5.9000,5.9100,8808,160
GMRE,8957,100,13.1600,200,13.0800,13.1000,8764,193
DLX,8941,100,33.4700,5,33.2500,33.2100,8799,142
DCI,8938,5,59.0200,19,58.9900,59.0100,8396,542
PKG,8934,100,141.0600,17,141.0000,141.0300,8672,262
PROS,8934,100,12.7100,100,12.5800,12.6500,8934,0
TCP,8934,500,31.9300,300,31.7000,31.8000,8916,18
DM+,8918,100,11.9300,100,11.7500,11.8000,6888,2030
HYLS,8915,100,49.0100,100,48.9700,49.0000,8085,830
UCTT,8914,246,43.4800,100,43.3500,43.3600,8813,101
VIRT,8904,100,24.8100,27,24.7900,24.8000,8418,486
FMTX,8894,100,35.9500,100,35.6900,35.7000,8867,27
CSTE,8891,200,13.7000,200,13.6100,13.6900,8891,0
BLCM,8890,100,4.4100,100,4.3300,4.3800,8744,146
ERII,8890,350,14.4500,100,14.4200,14.4400,8890,0
AVNS,8886,1,47.4600,100,47.4300,47.4500,8884,2
LILA,8877,100,11.1200,1,11.0800,11.0900,8877,0
THO,8874,30,107.7600,6,107.2300,107.2100,6924,1950
HE,8859,100,33.8800,200,33.8500,33.8600,8803,56
HTBK,8854,800,9.6000,97,9.5300,9.5400,8854,0
JACK,8852,200,101.6800,12,100.9500,101.1400,8581,271
LXU,8851,208,3.7400,20,3.7200,3.7400,8851,0
PB,8846,27,69.6400,1,69.5500,69.6100,8689,157
EBND,8839,1200,27.9000,700,27.8500,27.8900,8839,0
CUZ,8838,300,33.5300,300,33.3100,33.4700,8836,2
FXD,8836,200,54.8300,100,54.8100,54.8200,7336,1500
FIXX,8833,23,12.8200,100,12.7500,12.8100,8779,54
FAF,8816,4,55.0200,100,54.9700,55.0100,8741,75
SOHU,8814,100,17.9000,100,17.7500,17.7900,8814,0
H,8813,9,72.4900,1,72.1900,72.4400,7434,1379
STAA,8802,100,90.0500,13,89.5300,89.5300,8802,0
GVI,8763,500,117.1900,110,117.1700,117.1900,1563,7200
WING,8763,87,154.6600,100,154.3500,154.2500,8663,100
ELVT,8761,800,4.2600,1800,4.2000,4.2500,8761,0
MOH,8758,100,221.9500,100,221.6300,221.9800,8726,32
BOND,8737,200,112.5900,29,112.5700,112.5700,7243,1494
THRM,8729,47,70.8700,103,70.7500,70.8600,8258,471
DGNS,8727,200,12.9000,100,12.7400,12.8500,7827,900
ESS,8720,100,246.4200,100,246.1300,246.1400,8405,315
AGCO,8707,100,115.6200,3,115.2000,115.2000,8464,243
ONVO,8693,200,15.6400,700,15.4000,15.5800,8010,683
NULV,8678,400,33.8200,600,33.8100,33.8100,8673,5
COLB,8672,100,41.3000,100,41.0400,41.2200,8359,313
GALT,8670,100,2.1900,400,2.1700,2.1800,7283,1387
BNKU,8662,100,29.7900,100,29.7400,29.7700,8662,0
IYZ,8660,2100,31.4900,1701,31.4800,31.4900,5160,3500
SHC,8658,300,25.9300,100,25.7700,25.8600,8423,235
FLIC,8657,300,17.6500,100,17.6100,17.6500,8657,0
CCIV+,8643,100,6.8300,100,6.7200,6.7500,7810,833
CAAS,8638,100,7.3500,100,7.2100,7.3300,8381,257
ENVA,8613,200,24.8900,100,24.7800,24.8800,8613,0
CLOVW,8594,100,3.5900,100,3.5000,3.4700,8261,333
FDL,8590,5760,30.3300,1004,30.3200,30.3300,8590,0
BSCN,8579,5887,21.8500,1900,21.8400,21.8450,8579,0
IPGP,8579,1,253.4400,102,253.1700,253.3900,8353,226
ACC,8574,100,42.3300,200,42.1800,42.3200,8473,101
CLII,8571,102,13.2600,100,13.1500,13.2000,8469,102
BL,8570,35,132.4100,5,131.6800,131.8100,8570,0
KOMP,8568,100,67.3400,100,67.2900,67.3400,8468,100
QTEC,8566,300,146.5100,200,146.4400,146.3500,8566,0
CQP,8564,100,38.0000,100,37.8300,38.0300,8563,1
TAST,8556,300,6.9300,1400,6.8500,6.9100,8556,0
FAN,8552,100,25.3600,400,25.3500,25.3500,8552,0
FORM,8544,1,48.3200,28,48.0800,48.2800,8543,1
CALM,8526,100,37.3300,12,37.3100,37.3300,8426,100
AAN,8496,200,20.4900,395,20.4400,20.5000,8370,126
TTGT,8491,24,71.7200,100,71.6300,71.8200,8491,0
EME,8485,100,96.1000,100,95.6800,95.7500,8220,265
HZO,8483,58,43.8600,100,43.3800,43.6600,8346,137
WNC,8474,200,16.9500,2,16.9200,16.9600,8281,193
USX,8454,200,8.2100,100,8.1800,8.1900,7747,707
CIB,8445,100,37.7800,100,37.7200,37.7400,8445,0
CFB,8442,100,12.0000,100,11.9000,11.9300,8442,0
LBAI,8438,300,13.5600,120,13.4900,13.4900,8438,0
IUSG,8430,200,91.5800,1760,91.5600,91.5500,8430,0
TUSK,8428,100,4.6000,100,4.4800,4.5200,8328,100
VRNS,8401,100,179.9000,100,178.8600,179.0500,8112,289
ICON,8395,200,1.4600,200,1.4100,1.4300,6645,1750
RCI,8394,100,48.0300,200,47.9800,48.0000,7570,824
CERT,8387,1,37.2800,215,37.1200,37.2900,8371,16
COF-J,8387,100,25.9000,100,25.7600,25.8300,587,7800
LCAP,8387,100,10.5400,100,10.4500,10.4500,6188,2199
XOG,8371,100,31.1100,100,29.8800,29.9900,7172,1199
SRACW,8356,100,9.3100,100,8.9700,9.1700,7877,479
SILK,8346,241,62.1300,35,62.0200,62.2300,8275,71
INSP,8341,7,220.5500,131,220.1600,220.4200,8313,28
SIGI,8341,100,67.8500,69,67.5800,67.8400,8259,82
TMFC,8341,5880,36.2600,7070,36.2200,36.2400,8145,196
HRC,8338,4,100.2300,10,99.9400,100.0800,7984,354
BLKB,8331,121,65.2300,100,65.1500,65.1500,8331,0
LZB,8327,10,43.6300,100,43.5300,43.5600,8027,300
KW,8309,2,17.7900,400,17.7500,17.7900,8304,5
CDK,8290,29,50.6900,200,50.4500,50.6500,8278,12
SCOR,8288,2200,3.3300,100,3.3000,3.3000,7688,600
GLOB,8282,100,208.6200,35,207.4000,207.6400,8201,81
GOODN,8276,200,25.1800,100,25.1300,25.1800,8276,0
CUE,8271,100,14.0600,100,13.9000,13.9900,8031,240
RYTM,8267,100,36.1700,100,35.8600,35.9700,7810,457
VBR,8265,200,151.4300,200,151.3600,151.3800,8265,0
ALLE,8263,100,115.3300,8,115.2100,115.2500,8150,113
RDHL,8262,100,7.8700,1,7.8000,7.8300,4421,3841
IBML,8244,7600,26.2400,40,26.1800,26.2000,8224,20
KIDS,8242,100,42.7600,100,42.3100,42.6200,7902,340
CBD,8241,100,14.2200,200,14.2100,14.2200,6162,2079
TSC,8241,100,19.5300,100,19.3900,19.4200,8176,65
RMNI,8239,100,7.4800,100,7.4600,7.4400,8239,0
KRA,8230,100,31.4100,20,31.3600,31.3800,8230,0
LDOS,8229,53,109.1100,100,108.9800,109.1000,7665,564
NMCI,8227,700,5.2200,300,5.1800,5.2200,8187,40
GDOT,8226,160,56.6500,200,56.3800,56.6700,7825,401
TW,8224,6,65.0500,10,64.9400,65.0200,8099,125
EVOP,8208,600,28.4000,400,28.1900,28.3600,8203,5
TMX,8206,145,52.9600,100,52.7800,52.8000,8106,100
APXTW,8200,100,4.5300,100,4.4100,4.4500,8200,0
LIFE,8198,100,3.9300,100,3.8900,3.9300,6598,1600
MAAC,8197,100,10.3300,100,10.2800,10.3300,8197,0
SUI,8190,97,146.6800,100,146.0700,146.5100,8026,164
BLV,8188,153,106.7900,4,106.2300,106.3350,8188,0
TREB,8184,100,11.0000,200,10.9600,10.9900,7919,265
STBA,8180,101,28.0400,148,27.9700,28.0200,8180,0
RPM,8174,100,86.9900,126,86.6700,86.9600,7547,627
ATNM,8162,700,8.3500,200,8.2800,8.3000,8062,100
NZF,8162,4900,16.1200,100,16.0500,16.1200,4876,3286
OPENW,8160,100,13.9000,100,13.7700,13.7600,7446,714
PARR,8154,100,14.0300,200,13.9600,14.0200,7954,200
ZYME,8151,48,51.9500,100,51.3800,51.4100,8151,0
BAH,8131,100,94.7400,100,94.5700,94.5300,7479,652
CNTY,8129,100,7.1000,100,7.0700,7.0800,8129,0
RLH,8125,400,3.4700,450,3.4600,3.4650,6563,1562
ARES,8120,3,45.6300,63,45.4900,45.5900,8063,57
CYCC,8119,100,7.4700,100,7.3700,7.4500,5119,3000
AVLR,8118,100,164.9900,2,164.1500,163.9600,8005,113
MTEM,8108,100,11.4200,200,11.3100,11.3500,8008,100
BZQ,8080,2900,8.9700,1300,8.9500,8.9700,7780,300
SKYW,8073,2,42.0600,6,41.9500,42.0500,8073,0
CHH,8068,100,104.6700,100,103.8200,104.2400,8038,30
DXPE,8067,54,27.2000,100,26.9700,27.2000,8067,0
MUSA,8064,1,123.5500,67,123.3900,123.5500,8062,2
YJ,8062,100,2.5900,600,2.5600,2.5800,7249,813
HACK,8055,300,61.1300,700,61.0300,61.1100,5044,3011
SLVO,8051,800,6.4800,1000,6.4700,6.4700,8021,30
GMED,8048,150,66.3300,100,65.9500,66.1650,7769,279
GRX,8048,500,12.3700,100,12.2700,12.3100,300,7748
KBWD,8047,400,17.3100,500,17.2900,17.2500,8047,0
WWD,8047,100,123.3500,100,122.5700,122.5600,7906,141
RDNT,8042,100,20.0500,100,19.9400,20.0300,8042,0
SSP,8030,200,14.9400,400,14.8100,14.9200,7930,100
CANF,8025,283,2.0100,100,1.9700,2.0100,8025,0
GIX,8025,115,10.8600,100,10.8500,10.9000,4162,3863
AGTC,8009,100,4.7200,400,4.7000,4.7000,8009,0
SSB,8009,13,78.0300,100,77.8300,78.0000,8009,0
IDU,8003,100,77.9000,300,77.8900,77.9100,8003,0
CLDT,7999,171,11.6400,500,11.6000,11.6000,7991,8
APO,7998,200,48.1000,36,47.8900,48.0400,7778,220
FTSI,7992,6,19.8200,100,19.7000,19.8200,7992,0
VREX,7959,100,19.6400,100,19.5200,19.5900,7958,1
VAC,7945,21,140.7000,1,139.7200,139.6500,7845,100
LMNL,7938,1600,5.1000,100,5.0400,5.0600,7067,871
OPRA,7931,100,9.5900,200,9.5300,9.5500,3139,4792
IRT,7927,300,13.6500,200,13.6000,13.6000,7924,3
ESTA,7926,1,50.8100,200,50.6200,50.8100,7836,90
SGH,7916,37,41.7300,28,41.4500,41.5300,7816,100
PRFT,7906,100,52.3300,100,52.2500,52.3300,7783,123
SDIV,7905,185,13.3800,700,13.3700,13.3800,7905,0
VAPO,7904,400,31.8000,166,31.5500,31.6700,7893,11
AVAV,7903,100,129.9900,81,129.2700,129.3300,7755,148
PT,7900,200,1.1400,400,1.1000,1.1150,7900,0
KRON,7890,100,32.3100,100,31.5600,31.8900,7790,100
ATRC,7886,6,57.1300,32,56.8600,57.1000,7886,0
IDYA,7872,100,17.8100,38,17.6000,17.6800,7758,114
INGR,7871,100,77.9600,50,77.5000,77.6800,7799,72
VXF,7869,500,175.9500,200,175.7500,175.9400,7869,0
ESGD,7868,200,75.4000,1,75.3400,75.3800,7770,98
EVR,7855,100,115.5300,4,114.9700,115.1700,7543,312
PACK,7855,100,15.7000,28,15.5700,15.5900,7855,0
CFR,7844,34,95.8600,2,95.3800,95.6100,6082,1762
EHC,7844,100,87.5500,200,87.2700,87.3600,7330,514
IYT,7834,200,227.9100,200,227.8000,227.8300,6734,1100
RDWR,7829,100,28.3300,164,28.1600,28.1500,6508,1321
RNWK,7825,300,1.8000,200,1.7700,1.7700,7625,200
CHDN,7824,1,211.6700,6,211.4100,211.7700,7809,15
CURE,7814,300,86.7700,200,86.6900,86.7100,7814,0
VGM,7808,100,13.1500,100,13.0300,13.0900,7808,0
EPAC,7803,233,22.1100,200,22.0600,22.0900,7801,2
BYSI,7796,1000,13.0800,100,12.9500,12.9400,7751,45
GNLN,7789,100,5.2400,100,5.1900,5.1900,7683,106
SINO,7788,100,3.7000,200,3.5500,3.6500,7694,94
IPI,7777,100,24.6800,100,24.4100,24.5400,7772,5
BKI,7770,100,84.0700,100,83.8300,84.0500,7333,437
GFF,7767,100,23.5300,2,23.4200,23.4700,7491,276
AMCIW,7757,100,3.7300,100,3.6200,3.6000,7057,700
ACEVW,7754,100,2.7600,100,2.6800,2.7200,7554,200
PSN,7750,200,38.1100,2,38.0000,38.0400,7547,203
CSII,7747,1,46.6400,2,46.5600,46.6300,7746,1
STIC,7734,200,14.8800,100,14.8200,14.8150,7386,348
RBAC=,7725,100,11.7900,600,11.6800,11.7900,7115,610
VCNX,7722,402,2.6900,150,2.6600,2.6700,5724,1998
CRL,7719,100,281.4700,100,280.0700,281.4100,7463,256
III,7713,700,3.6000,200,3.5700,3.5700,7213,500
TRMK,7713,6,30.2500,100,30.1800,30.2200,7627,86
MMSI,7707,100,57.2100,100,57.0900,57.1700,7686,21
FTHM,7704,100,41.0600,100,40.2000,39.8000,7262,442
MNA,7693,300,33.5300,100,33.4400,33.4500,6707,986
STE,7691,100,189.1600,100,188.9200,189.0100,7296,395
EFSC,7688,100,36.9500,100,36.8000,36.9300,7638,50
IMMP,7685,100,3.3300,100,3.2800,3.3200,5785,1900
RVMD,7673,100,43.7500,100,43.2600,43.5800,7480,193
AIRG,7659,100,24.0900,300,23.8000,23.9200,7619,40
DXJ,7652,100,56.1700,200,56.1500,56.1500,7599,53
RACE,7652,28,215.7300,100,215.5300,215.4900,7124,528
NGACU,7646,100,11.0400,900,10.9900,10.9950,7646,0
QLYS,7635,100,121.8200,125,121.7200,121.7800,7476,159
GLP,7632,100,18.7900,100,18.5900,18.6800,7632,0
VRSK,7625,13,195.3400,100,195.1900,195.2900,7398,227
LCI,7617,101,6.6400,100,6.6200,6.6400,7617,0
BRC,7611,1,50.1200,100,50.0700,50.0300,7611,0
MRNS,7609,100,13.2900,200,13.1900,13.2300,7334,275
BKH,7608,90,60.5200,100,60.4600,60.4900,7172,436
BECN,7604,200,43.3100,100,43.2000,43.3000,7433,171
MESO,7601,100,9.4800,4000,9.4500,9.4600,7601,0
DRQ,7588,100,32.1000,100,31.9900,32.1400,7535,53
NEBCU,7575,100,11.4400,200,11.2600,11.4000,4778,2797
ARCH,7574,200,50.8100,100,50.5600,50.7300,7274,300
PKI,7574,100,150.6900,124,150.5300,150.5500,7033,541
DXF,7567,100,1.4700,100,1.4100,1.4050,7567,0
PYPD,7565,100,10.4500,100,10.2400,10.4100,6441,1124
NGG,7553,200,59.6800,100,59.6400,59.6700,7386,167
GWRE,7551,87,125.6000,5,125.5000,125.5400,7524,27
SVAL,7546,1700,26.7000,1700,26.6600,26.6800,7546,0
FGEN,7534,100,44.6700,5,44.6100,44.6600,7382,152
CBU,7532,20,68.4200,101,68.3700,68.4200,7531,1
AUDC,7522,400,32.3600,100,32.1000,32.2000,6263,1259
DESP,7513,100,11.4500,100,11.3500,11.4500,7513,0
XNCR,7501,11,48.7800,2,48.6500,48.6600,7501,0
QUAD,7499,1600,4.2400,1000,4.1700,4.2000,7499,0
NFBK,7494,100,13.1300,100,13.1000,13.1200,7493,1
RILY,7479,100,48.0700,100,47.6300,47.8000,7289,190
CFRX,7476,300,5.3100,200,5.3000,5.3000,7476,0
NUSC,7471,600,41.3200,100,41.2800,41.3000,7471,0
QURE,7444,127,39.0400,300,38.6500,38.8000,7312,132
VC,7442,100,143.6300,100,143.1300,143.1900,7265,177
KMPH,7437,100,5.9600,800,5.9000,5.9300,7094,343
USIO,7437,100,3.0900,1400,2.9800,3.0500,7137,300
MEG,7428,100,42.2000,100,41.7500,42.1000,6973,455
KNSL,7423,100,192.8000,100,191.6100,191.6600,6962,461
IEUR,7417,300,53.0500,1600,53.0200,53.0200,4378,3039
TRNO,7413,105,57.0200,100,56.9400,57.0300,7376,37
SCHK,7412,600,38.5800,100,38.5700,38.5900,7412,0
KOD,7409,37,159.9300,2,159.0200,159.1800,7397,12
MESA,7408,1600,6.7300,100,6.6800,6.6800,7408,0
POOL,7402,25,367.2100,132,366.9200,367.2100,6642,760
SCVX+,7400,100,1.8000,400,1.7700,1.7950,7400,0
SPNS,7397,100,33.6100,2,33.4500,33.3800,4561,2836
VSS,7396,100,125.7400,1,125.6300,125.6400,7396,0
SCHN,7395,82,31.1600,200,31.0000,31.1500,7379,16
GMAB,7394,500,43.3200,200,43.0700,43.1450,7294,100
TG,7393,100,15.8400,200,15.7600,15.7600,7386,7
AUTO,7387,101,3.4300,100,3.3700,3.4400,7287,100
SYNH,7379,1,75.8600,100,75.7300,75.7300,7304,75
JAZZ,7374,10,166.0500,1,165.8500,165.9600,7090,284
BAC-B,7370,100,27.4600,155,27.4100,27.4500,7370,0
CLPS,7368,110,3.4900,100,3.4300,3.4800,5921,1447
BRBR,7358,200,25.1200,200,24.9400,25.0000,7357,1
MTN,7353,8,272.2300,12,271.9100,272.1300,7353,0
SNDE,7352,100,2.1000,1,2.0800,2.1000,7152,200
HRTG,7346,100,10.2400,100,10.1600,10.2100,7314,32
WEAT,7345,7400,6.3300,1000,6.3200,6.3200,7335,10
NVCR,7337,7,172.3600,100,172.1400,172.2800,7257,80
IBUY,7307,400,126.2700,700,126.0100,126.1500,7307,0
KEX,7296,9,54.0800,100,53.9900,53.9900,6596,700
AZAJ,7292,200,26.9800,200,23.8200,25.3200,7292,0
OSK,7290,100,95.4400,100,95.3300,95.4800,7122,168
MRTN,7289,200,17.7000,100,17.6300,17.6800,7288,1
XSLV,7288,700,42.7500,400,42.7100,42.7000,7288,0
ENV,7287,100,87.5200,100,86.8600,87.0600,6962,325
HONE,7277,100,11.1300,1,11.0900,11.0900,7077,200
UONE,7276,1600,6.0600,100,6.0300,6.0200,7276,0
SMSI,7268,100,6.8300,105,6.8100,6.8150,7168,100
PJAN,7257,500,30.9300,7000,30.8100,30.9200,6977,280
ENSG,7248,5,83.9600,112,83.8100,83.8100,7137,111
OCFT,7242,100,21.8000,100,21.7000,21.7900,7189,53
CBRL,7238,30,140.9300,9,140.6900,140.6700,7237,1
RUHN,7236,800,3.3000,100,3.2200,3.2900,7236,0
HGSH,7233,500,2.1800,100,2.1200,2.1700,7233,0
VSSYW,7233,100,3.1900,100,3.0600,3.0000,6187,1046
FNCL,7227,800,44.0700,220,44.0500,44.0700,7063,164
LEGOU,7222,3400,10.3200,300,10.3100,10.3050,7222,0
AAWW,7212,180,52.6600,10,52.4400,52.5100,7061,151
PCEF,7208,600,22.5500,100,22.5300,22.5500,6808,400
FDRR,7207,100,38.0800,500,38.0200,38.0400,6602,605
DOX,7204,24,70.9700,62,70.9400,70.9400,7163,41
OMAB,7185,100,49.1200,300,48.9000,49.0400,7171,14
DFIN,7181,100,19.4700,100,19.2600,19.3800,7181,0
XIN,7174,200,2.5400,100,2.4800,2.5300,5359,1815
DMF,7170,100,8.9300,100,8.8200,8.8900,2442,4728
FIF,7152,100,11.2800,100,11.2300,11.2300,803,6349
DAC,7150,100,28.5700,100,28.3000,28.5000,6550,600
NHI,7139,100,66.3600,46,65.9400,66.0800,6590,549
SA,7137,100,20.2200,7,20.1900,20.1900,6946,191
CCOI,7134,100,59.7200,200,59.4400,59.3800,6743,391
ESTE,7127,200,5.7900,1000,5.7200,5.7500,7127,0
BHR,7115,100,4.7800,200,4.7600,4.7850,6785,330
BOAC=,7109,400,12.4800,976,12.4000,12.4800,6909,200
EPHYU,7108,100,11.0200,100,10.9700,10.9800,7108,0
AVB,7107,21,166.1200,100,166.0200,166.1400,6477,630
PTMC,7102,400,33.7500,300,33.7100,33.7200,6902,200
BCAT,7100,100,22.1800,100,21.8400,21.9800,7000,100
SNR,7095,100,5.6100,600,5.6000,5.6150,6676,419
FPXI,7094,1200,73.4300,400,73.1100,73.3600,3694,3400
ICUI,7093,100,218.0200,5,216.6500,216.6500,7035,58
XLRN,7078,1,125.2700,275,125.1200,125.1200,7070,8
DBVT,7065,1600,6.5800,100,6.5300,6.5200,7065,0
SNA,7064,4,176.3500,100,176.2100,176.3000,6688,376
XFOR,7063,200,8.4200,100,8.2500,8.4000,7063,0
TWI,7061,1400,6.8400,100,6.7600,6.8000,7050,11
ESPO,7060,400,75.0600,400,74.9300,75.0000,6960,100
FENG,7059,200,1.6100,300,1.5900,1.6000,7059,0
DLPN,7046,200,3.9800,100,3.8900,3.8600,7046,0
UFI,7041,100,19.1900,100,19.0800,19.1900,6941,100
SUB,7039,300,108.1700,200,108.0400,108.0900,6839,200
IT,7036,1,161.3800,31,161.2200,161.3600,6636,400
STEP,7032,200,38.2000,149,37.9000,38.0100,6944,88
SHEN,7029,100,43.4500,100,43.0800,43.2300,7028,1
STC,7027,100,50.6400,100,50.4500,50.5400,7027,0
CRHC=,7026,400,11.4200,1000,11.3600,11.4000,7026,0
VOT,7020,100,219.1400,200,219.0700,218.9700,6706,314
CIXX,7015,100,13.3300,100,13.2600,13.3300,2916,4099
ALEX,7005,600,16.5800,2,16.4800,16.5000,6945,60
PHB,7000,2800,19.4200,300,19.4000,19.4000,7000,0
BGNE,6999,100,355.6200,100,351.9200,354.7600,6903,96
TSE,6998,100,55.4300,100,55.0200,55.3000,6695,303
GLPG,6995,100,112.0400,100,111.3900,111.8700,6545,450
VNLA,6987,400,50.4600,600,50.4500,50.4600,6587,400
GNT,6975,1012,5.1300,101,5.0900,5.1250,1972,5003
WIRE,6959,100,60.5000,301,60.4300,60.4900,6859,100
HIGA,6957,200,10.3100,100,10.3000,10.3000,6957,0
CPF,6951,200,20.2300,35,20.1800,20.2000,6950,1
MSCI,6950,1,416.3900,113,415.8500,416.1700,6899,51
CFACU,6944,100,12.9300,900,12.8600,12.8800,6527,417
TCCO,6936,100,4.2100,100,4.1000,4.2000,6936,0
STMP,6926,4,225.6000,100,224.8600,225.3500,6925,1
YI,6919,100,8.3800,100,8.2200,8.2000,6868,51
BTWNW,6915,100,4.3600,100,4.2100,4.2500,2867,4048
CVGI,6900,200,9.0000,205,8.9500,8.9800,5961,939
AKTX,6897,100,3.0200,100,2.9400,2.9600,6197,700
AAIC,6890,150,3.8600,100,3.8400,3.8600,6890,0
MMYT,6890,400,31.9300,200,31.7000,31.6600,6781,109
PCVX,6885,100,24.0500,100,23.5500,23.7000,6789,96
DAKT,6883,364,5.2100,200,5.1700,5.1700,6860,23
CDZI,6880,100,11.0200,100,10.9800,11.0100,6800,80
UHS,6870,2,130.6900,41,130.5700,130.6400,6386,484
RUBY,6853,100,9.2800,26,9.2100,9.2200,5741,1112
INSW,6851,100,17.1800,100,17.0600,17.1100,6851,0
SEED,6850,300,22.9800,100,22.7200,22.9500,6248,602
CRUS,6840,20,100.0500,96,99.7700,99.8300,6546,294
BXS,6835,3,29.7600,200,29.7100,29.7600,6835,0
CRESY,6835,100,5.4300,800,5.3400,5.4600,6835,0
ZVO,6835,700,5.4100,800,5.3300,5.3600,6791,44
SHYD,6827,100,25.1900,50,25.1000,25.1600,6827,0
SV,6822,100,10.8300,200,10.6900,10.7700,6222,600
LUXE,6819,208,27.5200,500,27.4300,27.5100,6819,0
TDY,6818,13,389.4200,6,389.0200,389.1400,6088,730
BRPAW,6817,100,8.5300,100,8.2100,8.8000,6527,290
BDRY,6814,100,11.3500,147,11.3200,11.3400,6668,146
CMLFU,6807,100,13.0000,900,12.9600,12.9400,6807,0
IMXI,6806,52,15.3800,110,15.3300,15.3400,6806,0
LASR,6801,114,35.8500,200,35.6000,35.7000,6801,0
MLI,6797,200,37.9200,6,37.6800,37.6300,6738,59
EZPW,6794,200,4.6900,400,4.6800,4.7000,6693,101
TUFN,6788,100,18.0300,100,17.9100,17.9500,6267,521
ELS,6780,200,61.7700,100,61.5800,61.6000,5977,803
ROBO,6762,900,67.5900,100,67.5300,67.5300,6107,655
NTCO,6758,100,18.3900,600,18.3700,18.3800,6757,1
SCHR,6741,9800,57.8800,22880,57.8700,57.8750,6741,0
EDSA,6740,100,5.1800,100,5.0700,5.1300,6605,135
CYBR,6737,15,162.1300,100,161.1900,162.0500,6605,132
IBDM,6720,5852,24.9100,1900,24.9000,24.9100,6720,0
RC,6714,100,12.3600,100,12.2700,12.3300,6554,160
AOSL,6708,100,30.9300,100,30.7700,30.8600,6708,0
BTZ,6708,100,14.9300,1000,14.8800,14.9300,1680,5028
CWST,6707,65,59.6000,401,59.3400,59.4500,6702,5
AXAS,6706,100,2.7300,1222,2.6700,2.7400,3706,3000
XPOA=,6706,400,11.6400,900,11.5900,11.4300,6706,0
AVAL,6705,200,6.7300,100,6.7000,6.7100,6705,0
POST,6702,100,99.5300,100,98.8600,99.1900,6630,72
CTHR,6700,100,1.4200,400,1.4000,1.4000,6700,0
BATT,6691,2000,18.4200,1,18.4100,18.3950,6691,0
EBS,6676,63,110.4400,200,109.8200,110.0000,6637,39
NERD,6676,300,33.4700,400,33.3600,33.4400,6676,0
XSD,6666,100,192.2900,200,192.1700,192.2800,6666,0
JJSF,6652,38,151.9200,6,151.6000,151.7300,6652,0
REXR,6648,80,49.7000,200,49.5500,49.6800,5930,718
GTLS,6643,100,139.7400,100,138.2200,138.6700,6409,234
ACHC,6641,300,51.7500,2,51.7000,51.7400,6441,200
TBPH,6641,100,18.0000,100,17.8800,18.0100,6641,0
WOR,6619,100,54.4100,22,54.2400,54.2100,6609,10
LODE,6617,200,1.1800,200,1.1700,1.1700,6517,100
FTAI,6614,100,23.6900,100,23.4900,23.5600,4714,1900
SUSB,6612,2667,26.1700,100,26.1600,26.1600,6612,0
IWO,6606,400,313.4600,200,312.8900,313.0300,5967,639
QAI,6600,1200,32.4300,300,32.4100,32.4300,6600,0
BTWNU,6592,500,16.5100,400,16.4000,16.3800,6492,100
COLL,6587,104,23.3700,40,23.3300,23.3500,6551,36
SPB,6578,10,79.4300,100,78.9900,79.3000,6484,94
CONN,6573,5,13.8500,200,13.8200,13.8500,6551,22
HTGC,6567,100,15.3100,100,15.2600,15.2650,5148,1419
BCAB,6566,100,44.7700,100,43.8500,44.2300,4056,2510
FSKR,6564,100,16.9800,200,16.9000,16.9300,6128,436
TRHC,6563,40,52.7400,2,52.6600,52.7200,6463,100
LOOP,6560,100,10.0200,200,9.9500,9.9800,5960,600
WBAI,6559,100,12.8400,100,12.6400,12.8000,6079,480
SCHJ,6557,100,51.3500,538,51.3400,51.3450,5857,700
DMYI=,6551,1100,12.2400,900,12.1900,12.2400,6351,200
PAYC,6540,5,405.4900,12,405.0300,405.4300,5722,818
KRMD,6537,5,5.1800,1100,5.1300,5.1900,6322,215
LSEAW,6529,100,0.2900,900,0.2700,0.2712,6529,0
BETZ,6513,1000,29.5500,400,29.4400,29.5000,6413,100
GLOP,6513,100,3.5300,100,3.4500,3.4900,5988,525
AYLA,6510,100,13.9100,100,13.2400,13.7900,4504,2006
GPI,6510,37,154.7200,1,153.4100,153.6200,6510,0
NMFC,6502,100,11.8500,5,11.8200,11.8100,6407,95
IVOL,6500,300,28.5400,200,28.5000,28.5200,6400,100
PHIOW,6500,300,0.3584,300,0.1584,0.2000,1100,5400
EPP,6497,900,50.4100,900,50.3900,50.4000,6497,0
HIL,6492,1700,2.3200,1000,2.2800,2.3100,6492,0
TCDA,6482,207,7.2600,200,7.2000,7.2300,4482,2000
THCA,6478,100,11.0500,100,10.9700,11.0000,6127,351
UTSI,6477,100,1.9700,100,1.9000,1.9300,6377,100
TRTN,6475,200,49.6800,2,49.4200,49.4500,6445,30
LAMR,6464,71,84.1000,100,84.0300,84.0800,6459,5
JLL,6453,100,155.1000,100,153.6600,154.5200,5773,680
UMBF,6453,2,72.6500,100,72.5200,72.4900,6453,0
STPC=,6450,30,13.3600,300,12.0900,12.0950,5580,870
MTSC,6442,47,59.4200,203,59.3200,59.3500,6343,99
MDXG,6440,100,8.8300,100,8.7300,8.8000,6440,0
RSVA,6439,200,15.1700,200,13.7800,14.5000,6339,100
CRHM,6437,400,2.2600,500,2.2500,2.2600,6337,100
SFBS,6435,100,42.6400,100,42.3800,42.5000,6434,1
IEX,6427,28,195.5600,1,195.3800,195.4500,6361,66
RNST,6424,1,37.4700,100,37.3700,37.4300,6328,96
DTSS,6412,100,3.5600,100,3.4400,3.4800,6242,170
CHMI,6408,1,9.1800,100,9.1500,9.1700,6408,0
ATEX,6405,100,40.2100,100,39.5800,39.8800,6282,123
IYY,6400,300,97.4200,200,97.4000,97.2800,6100,300
FXE,6398,100,114.2000,2400,114.1800,114.1300,6373,25
EQH-C,6393,100,25.0400,100,24.8900,24.9000,3793,2600
WKEY,6393,100,6.8500,300,6.7500,6.7900,6393,0
SPIP,6390,26200,31.1800,12100,31.1600,31.1300,6390,0
WAT,6389,1,271.8600,2,271.6400,271.8400,6221,168
EQC,6388,100,28.0600,100,28.0300,28.0400,4952,1436
NBAC,6382,200,17.9400,100,17.7500,17.7100,5682,700
AGC,6379,100,16.6800,100,16.5300,16.6400,5079,1300
AZRE,6374,50,47.0700,200,46.6800,46.8400,6205,169
MEDP,6372,100,143.7600,100,143.4600,143.5600,6283,89
PATK,6362,100,73.1700,100,72.5700,72.9100,6272,90
SWIR,6358,182,18.4600,100,18.4200,18.3800,6358,0
ALBO,6355,100,35.2100,100,34.9400,34.9600,6127,228
OCG,6355,300,5.0400,500,5.0000,5.0200,6150,205
MASI,6348,100,261.5200,100,260.1600,261.2000,6347,1
TREE,6348,100,316.4000,3,314.6600,314.9700,6331,17
MIND,6345,5,2.2000,100,2.1600,2.1800,6345,0
AONE,6331,100,11.2600,100,11.1600,11.2100,6031,300
PSEP,6325,8400,28.3000,400,28.1400,28.1600,6325,0
PW,6324,60,29.3000,200,29.1100,29.2700,6322,2
LIND,6314,200,17.3400,10,17.3000,17.2800,6152,162
AGRO,6311,300,7.8100,800,7.7300,7.7800,6233,78
BSCM,6306,4644,21.7100,2750,21.7000,21.7050,5706,600
LEGN,6303,100,29.3100,100,29.1800,29.1900,6139,164
LEXX,6303,100,4.3300,400,4.2500,4.3000,6003,300
PRO,6295,1,44.1000,3,44.0100,44.0500,6295,0
FTSM,6268,3000,60.0500,10632,60.0400,60.0450,6268,0
LPI,6267,500,24.7200,100,24.4300,24.5000,6267,0
PRA,6262,200,19.4100,113,19.3800,19.4400,6189,73
SLF,6238,300,48.4900,300,48.4700,48.5100,5282,956
VGIT,6234,25200,69.0200,8700,69.0100,69.0100,6234,0
AMSWA,6233,300,20.2200,100,20.0500,20.0600,6233,0
SXT,6231,1,75.8400,1,75.6400,75.7800,6203,28
DPST,6230,10,159.1300,100,158.8700,159.7600,6182,48
DBEU,6207,100,30.9800,400,30.9600,30.9600,4007,2200
SMIN,6205,900,44.5200,1300,44.3500,44.4000,6205,0
FSS,6204,100,35.3500,200,35.1700,35.3500,6130,74
CNF,6200,100,3.0300,3,2.9500,3.0000,6200,0
EFC,6198,102,15.8200,200,15.8000,15.8200,6159,39
LORL,6192,5,26.3200,100,26.0400,26.0700,5403,789
DNP,6188,200,10.3400,900,10.3200,10.3300,6188,0
MGV,6187,300,89.4200,2490,89.3900,89.4300,6187,0
EPOL,6177,300,19.0900,300,18.9900,19.0500,6177,0
AUTL,6175,100,8.5200,100,8.4200,8.4300,6105,70
PAC,6172,100,105.3700,300,105.1500,105.3700,6172,0
SPTM,6161,900,47.6100,1000,47.5900,47.5900,6150,11
IDXG,6160,100,4.2500,100,4.1600,4.1200,6160,0
ONOF,6160,1000,25.4800,400,25.2600,25.4300,6130,30
GDV,6158,200,22.4400,5,22.3500,22.4400,4360,1798
THD,6157,100,80.1900,200,80.0500,80.2100,6157,0
EOD,6150,100,5.0800,1000,5.0200,5.0400,808,5342
CENTA,6149,40,39.1600,40,39.0900,39.1400,6148,1
FSP,6144,300,4.5600,100,4.5500,4.5500,5877,267
MOXC,6143,25,1.7300,100,1.6900,1.7300,6143,0
ARQT,6136,1,27.5900,100,27.2900,27.5000,6136,0
SKM,6133,50,25.9300,400,25.8200,25.9200,6133,0
AGCUU,6130,100,17.5600,100,17.2500,17.2500,6000,130
EPAM,6127,100,364.7400,14,362.9700,363.1700,5933,194
SCVX,6127,100,10.7800,100,10.6000,10.6450,2360,3767
T-C,6120,100,25.8000,100,25.5500,25.7100,5028,1092
NGVT,6118,100,72.1300,5,71.9600,71.9400,6116,2
AFYA,6111,100,24.1100,100,23.9500,24.0300,6111,0
OAS,6104,257,40.7600,100,40.4400,40.5300,6082,22
TFII,6098,100,52.2600,5,52.2100,52.2100,4898,1200
RBC,6097,100,133.8000,100,133.5500,133.6200,5993,104
MDRR,6091,100,2.4500,100,2.3500,2.3600,4241,1850
AKRO,6081,100,30.0800,200,29.7400,29.9300,6081,0
ARBGW,6080,200,1.8100,200,1.5700,1.6500,6080,0
HCHC,6067,200,3.5400,2900,3.5000,3.5250,5967,100
FARO,6056,44,75.5400,69,75.4000,75.3100,6056,0
COO,6050,14,378.4400,14,377.7600,377.8700,5185,865
ZDGE,6048,100,7.7500,100,7.6500,7.7000,5711,337
FTXO,6036,3000,26.3200,2300,26.3100,26.3200,6036,0
CHRA,6032,2500,4.2600,200,4.1800,4.1900,5627,405
VCVC,6030,200,10.6200,100,10.5200,10.5800,5530,500
RTPZ=,6028,100,12.9500,400,12.6900,12.8000,6008,20
LOB,6026,100,47.5200,1,47.1700,47.1900,6026,0
FXZ,6022,1500,50.9500,300,50.9200,51.0000,6022,0
AAP,6020,2,166.9200,100,166.7900,166.8700,5918,102
SPH,6019,121,15.2900,200,15.2300,15.2600,5440,579
WH,6017,2,62.1000,6,61.9900,62.0100,6012,5
AVEO,6012,111,8.5200,100,8.4600,8.5100,6012,0
CBLI,6008,100,4.1300,100,4.0300,4.0600,2618,3390
SEAH+,6005,100,1.7700,100,1.6700,1.7500,5805,200
EVT,6004,100,24.2200,100,24.0200,24.1200,5904,100
SPXC,5998,100,58.9500,100,58.6300,58.9000,5921,77
FREQ,5994,29,36.2200,100,35.8200,36.0950,5883,111
SPNV,5984,300,11.3000,300,11.2500,11.3000,5784,200
COWZ,5982,1400,35.9700,800,35.9400,35.9400,5982,0
IBDR,5975,1500,27.0000,200,26.9900,26.9700,5375,600
LFC,5973,400,11.7400,500,11.7300,11.7300,5973,0
CNMD,5971,3,120.7200,100,120.0700,120.9900,5898,73
GL,5971,57,96.0300,100,95.8900,95.9700,5857,114
JKE,5969,100,298.5100,30,298.4300,298.3400,5539,430
MPAA,5969,100,21.1100,2,20.8800,21.0300,5918,51
IYJ,5966,77,98.4200,1214,98.3900,98.4200,5966,0
CVLT,5956,1,58.8400,14,58.6600,58.6500,5831,125
SCHI,5955,100,53.2800,100,53.2700,53.2650,5613,342
ALAC,5949,100,15.3400,100,15.0100,15.2900,5804,145
TWCTU,5946,100,11.6500,100,11.4600,11.5000,5946,0
PBFX,5944,100,10.1800,100,10.0400,10.1100,5944,0
SAIC,5942,121,100.0000,100,99.7000,99.6700,5942,0
OLED,5940,100,256.2100,200,254.9000,255.1900,5734,206
RAPT,5937,31,21.0900,200,20.8400,20.9600,5937,0
AZZ,5935,100,48.8700,100,48.4100,48.5800,5878,57
CVLG,5934,100,16.9300,100,16.6500,16.7900,5895,39
EVK,5934,100,3.8200,300,3.7300,3.7400,5934,0
VAR,5934,99,175.6500,600,175.6200,175.6500,5647,287
TEO,5933,1300,6.4300,1300,6.3600,6.4150,5930,3
GHLD,5930,100,17.0000,6700,16.4000,16.7800,5784,146
AOUT,5926,5,18.8500,100,18.6700,18.7200,5668,258
GTY,5914,13,27.1500,100,27.0900,27.1600,5914,0
DY,5904,100,89.9500,100,89.1600,89.5600,5731,173
SNRHU,5899,1,10.9000,200,10.8600,10.8900,5899,0
OTTR,5897,54,41.4600,100,41.2400,41.3900,5897,0
MRM,5890,100,13.9500,100,13.7000,13.9000,5783,107
PCPL+,5890,100,2.5900,100,2.4600,2.5000,5360,530
LTC,5887,200,39.7200,101,39.6700,39.7000,5857,30
USCR,5882,100,48.3100,45,48.1800,48.1950,5726,156
WABC,5875,100,59.9400,100,59.6800,59.9300,5874,1
FDMT,5869,100,47.4800,100,46.7800,47.0000,2633,3236
SRE-B,5864,92,101.4600,697,100.9600,101.4500,4010,1854
IBHB,5861,230,24.3000,222,24.2600,24.3100,5861,0
SPRO,5836,100,17.7900,100,17.5600,17.7400,5836,0
YMAB,5834,100,45.2400,100,44.6500,45.0600,5585,249
FIVG,5833,700,35.6700,400,35.6600,35.6700,5633,200
FCACU,5832,300,11.8900,900,11.8000,11.8100,4432,1400
IPOE+,5828,100,8.3700,100,8.2900,8.3300,4909,919
CCMP,5827,100,168.2700,100,167.0600,167.0500,5627,200
FCFS,5826,5,58.6200,103,58.4400,58.3500,5826,0
PRTA,5825,32,13.4000,100,13.3500,13.3600,5743,82
ROCK,5823,100,96.0100,25,95.5700,95.6800,5782,41
LAKE,5813,100,27.4500,100,27.1600,27.2400,5613,200
FRGAP,5811,100,24.8200,500,24.6300,24.7200,3311,2500
SBBP,5805,100,2.9200,500,2.9100,2.9100,5160,645
JW.A,5801,158,48.2000,50,48.0200,48.0300,5652,149
RSVAU,5800,200,16.8600,100,16.6900,16.6600,5600,200
TREB=,5800,400,11.8000,200,11.6700,11.5100,5800,0
DGNR,5798,300,14.8000,100,14.6900,14.6300,5498,300
HUBS,5790,100,392.0300,7,390.4400,390.5000,5784,6
AIRI,5786,5100,1.5800,200,1.5500,1.5600,5686,100
IYM,5784,800,117.9200,200,117.8800,117.7700,5584,200
PPLT,5779,1000,105.7000,47,105.1500,105.2500,4859,920
EKSO,5777,100,9.2600,100,9.1200,9.1950,5709,68
EMQQ,5777,600,72.1300,600,71.9700,72.0400,5777,0
PTY,5777,200,17.9800,200,17.9600,17.9500,5777,0
BOKF,5768,13,78.3300,100,77.9300,78.3300,5764,4
SCHZ,5762,1882,55.6000,700,55.5900,55.5950,5384,378
EQD,5758,100,10.7500,200,10.6400,10.6700,5758,0
MHLD,5758,200,2.4800,1100,2.4700,2.4800,5558,200
BSGM,5754,3,4.6900,100,4.6500,4.6600,5754,0
ACIC,5749,196,10.6200,200,10.5300,10.6200,5749,0
ECOM,5748,100,19.6500,100,19.4600,19.5300,5518,230
LUNA,5743,100,11.3200,100,11.1900,11.2100,5743,0
PGTI,5743,1,23.2800,1,23.2100,23.2200,5443,300
CTRN,5739,5,62.2800,100,62.0300,62.4200,5719,20
LCUT,5737,100,15.1800,100,14.9400,15.0900,5737,0
TCPC,5735,100,12.0700,100,12.0200,12.0400,5735,0
ACBI,5725,100,17.0100,100,16.9500,17.0400,5725,0
UTHR,5721,100,167.1600,100,167.0100,167.0300,5454,267
FRX,5719,200,10.6500,141,10.5600,10.5500,5719,0
PRTH,5719,100,7.6800,100,7.5100,7.5500,5625,94
REV,5718,100,10.1600,100,10.1400,10.1600,5718,0
BLCT,5717,200,10.2900,100,10.2000,10.2700,5707,10
AX,5712,100,41.2400,13,41.0600,41.1200,5709,3
RCEL,5708,100,27.0600,200,26.9200,27.0800,5608,100
FNGU,5704,300,336.5000,100,336.1400,335.3200,5688,16
BSCR,5700,100,22.3200,200,22.3000,22.3100,3600,2100
ECHO,5696,19,28.1200,200,28.0300,28.0700,5679,17
SLGN,5693,1,37.0600,20,37.0400,37.0300,5475,218
FST,5679,400,10.7000,100,10.6500,10.7000,5679,0
RNR,5674,5,159.8400,39,159.6900,159.7500,5491,183
NTUS,5666,100,26.7100,100,26.6100,26.6700,4806,860
LE,5662,51,29.0900,200,28.9500,29.0400,5662,0
NESR,5651,600,10.0800,200,9.9700,10.0200,5651,0
TITN,5643,100,22.4500,100,22.3300,22.3300,4915,728
PRAH,5639,3,135.3300,100,134.9900,135.3200,5615,24
KZIA,5638,100,11.9700,100,11.7700,12.0000,5138,500
ITT,5628,2,80.9900,100,80.6000,80.8600,5476,152
EEMA,5620,100,96.9500,100,96.4000,96.3000,5620,0
WPG,5617,100,11.2100,1000,11.0600,11.1500,5617,0
AVY,5614,200,160.3200,1,160.2300,160.2900,5197,417
RUSHA,5611,100,45.3000,69,44.9800,44.9800,5611,0
AXDX,5605,100,8.5700,100,8.5100,8.5400,5505,100
SPNE,5605,100,16.7800,100,16.5100,16.7100,5203,402
VERX,5604,24,31.9400,59,31.7500,31.8800,5243,361
R,5603,22,68.7500,21,68.5800,68.6000,5601,2
BAND,5599,100,168.5500,100,168.1500,168.3900,5599,0
SMCI,5595,1,33.7400,100,33.6400,33.6800,5394,201
LOVE,5589,100,54.6500,200,54.1500,54.0700,5589,0
PDP,5586,700,90.7600,500,90.7100,90.7400,5586,0
WIX,5576,100,249.3400,100,247.7000,247.8400,5446,130
CLFD,5575,100,32.7200,100,32.3500,32.5400,5575,0
AXSM,5569,100,76.3900,1,75.9900,76.0200,5209,360
IDT,5569,100,13.8000,100,13.6600,13.7300,5569,0
MATX,5568,2,66.7300,109,66.6000,66.6200,5567,1
LIZI,5567,300,3.8500,100,3.8200,3.8200,5567,0
VBTX,5566,200,28.4000,100,28.1800,28.2900,5566,0
EFX,5564,3,178.9100,30,178.7600,178.8700,5476,88
VMAR,5564,100,15.4400,100,15.2400,15.3600,5464,100
AVRO,5563,200,14.2800,100,14.1900,14.2100,5163,400
SPSC,5563,100,110.2600,31,110.1200,110.1100,5554,9
AEMD,5558,3900,2.7600,100,2.7100,2.7300,5558,0
LHCG,5558,7,214.3600,5,213.9800,214.0550,5558,0
INFU,5557,100,17.6900,100,17.4700,17.4300,5554,3
BBIN,5549,300,57.0800,800,57.0400,56.8400,5549,0
AIZ,5548,15,138.1800,1,138.1100,138.2200,5496,52
WSFS,5548,100,46.4100,100,46.3200,46.4000,5544,4
TECH,5541,1,356.6100,10,355.5300,355.4200,5518,23
FICO,5534,1,488.5500,12,486.0900,488.7900,5263,271
ODT,5529,100,19.6700,122,19.5100,19.5800,5483,46
IWS,5523,200,101.2100,400,101.1600,101.1700,5523,0
IIIN,5504,100,27.6600,100,27.3800,27.5600,5151,353
PODD,5503,100,290.3900,1,290.1500,290.3800,5426,77
AAAU,5500,25900,18.6100,13500,18.6000,18.5700,0,5500
EYEN,5500,300,6.8100,100,6.7400,6.7900,5200,300
NFG,5500,100,41.6800,9,41.6000,41.6400,4734,766
PUK,5500,300,39.4600,500,39.2600,39.3800,5400,100
FXF,5494,1000,102.8400,1300,102.8100,102.8400,5494,0
PFPT,5494,100,138.3700,1,137.7600,137.6600,5455,39
OUSM,5483,600,32.2800,2800,32.2500,32.2700,5463,20
NNBR,5476,4,6.2500,100,6.2100,6.2100,5476,0
SFE,5465,100,6.9200,400,6.8300,6.8600,5365,100
CLH,5460,100,83.0300,100,82.4800,82.7700,5356,104
LII,5460,48,293.9500,1,293.4700,293.9400,5123,337
HVT,5459,300,33.2400,100,32.9900,33.1200,5459,0
FLMN,5458,100,3.5000,100,3.4700,3.5000,5326,132
NVMI,5452,17,79.5100,100,78.8200,79.2400,3977,1475
CAMP,5451,100,10.9800,200,10.9500,10.9800,5193,258
MILN,5450,39,39.0900,2039,39.0200,39.0600,5411,39
SSTK,5450,8,72.3100,101,72.2400,72.2400,4977,473
AFBI,5444,100,10.9100,9000,10.7500,10.8000,4044,1400
FITBI,5444,100,28.8900,100,28.6200,28.8400,5444,0
FOR,5438,105,22.8800,100,22.6300,22.7600,4995,443
THR,5415,100,16.4500,100,16.2900,16.3400,5415,0
KALV,5414,100,16.0100,100,15.8300,15.9500,5414,0
HHC,5412,100,88.4500,79,88.1200,88.1600,5331,81
CMSD,5407,100,27.2200,100,27.2100,27.2800,5407,0
SMMT,5401,100,5.3700,800,5.2400,5.3200,5401,0
BFAM,5400,100,160.3800,100,159.6700,159.5900,4892,508
PFL,5400,100,11.4900,104,11.3800,11.4500,5400,0
GOLF,5399,1,41.0100,100,40.8100,40.9700,5299,100
PEJ,5399,200,42.6000,200,42.5600,42.5900,5199,200
EIGR,5398,200,10.6600,100,10.5300,10.5600,5398,0
WSR,5397,100,8.3500,100,8.3200,8.3400,4970,427
COPX,5389,100,32.9800,100,32.9500,32.9700,4589,800
PAM,5385,243,12.6700,100,12.6000,12.6100,5285,100
HELE,5384,100,235.3600,100,233.4900,234.0600,5127,257
FLNT,5381,300,4.5000,2500,4.4400,4.4700,4343,1038
TCBK,5378,100,39.9000,103,39.7100,39.9100,5282,96
KELYA,5376,100,21.1100,100,21.0700,21.0900,5335,41
AEIS,5374,100,120.8100,100,119.7700,120.2300,5256,118
BANR,5373,100,50.9300,200,50.5800,50.7800,5373,0
MKSI,5369,134,186.0000,30,185.0000,184.9900,4685,684
BMRA,5368,200,6.3000,100,6.2100,6.2700,5268,100
MKTX,5367,100,514.4500,33,513.6900,513.8600,5270,97
GSHD,5365,10,143.6400,100,142.2300,143.0900,5265,100
ACA,5362,100,62.0900,100,61.8200,62.0800,5218,144
KGRN,5358,300,51.6300,300,51.4500,51.4900,2258,3100
DSSI,5353,200,6.7900,100,6.7300,6.7300,5053,300
RGA,5348,7,111.4800,3,111.2600,111.2550,5309,39
RE,5339,21,233.8000,20,233.4400,233.2500,5273,66
AXS,5333,12,50.2200,3,50.1800,50.1900,5333,0
TMDX,5333,100,24.0900,100,23.7500,23.9000,5333,0
NDSN,5332,100,193.8000,5,192.7800,192.7200,5233,99
NOMD,5329,400,25.7500,97,25.6500,25.6600,5229,100
HOLI,5320,800,14.2100,300,14.1000,14.1300,5219,101
MIST,5319,100,7.3100,100,7.1700,7.2200,5319,0
NCMI,5316,100,3.7000,366,3.6900,3.7000,5316,0
CORN,5312,500,16.5700,400,16.5400,16.5400,5312,0
LECO,5309,1,121.5400,165,121.4500,121.5000,5144,165
CTT,5308,1000,9.7700,108,9.7100,9.6900,5282,26
IWP,5303,200,107.1200,25,107.0600,107.0800,5298,5
SP,5299,100,31.2700,249,31.0000,31.1300,5259,40
VRTU,5295,100,51.2000,402,51.1800,51.1850,5136,159
FORR,5293,375,44.0100,100,43.8300,43.8400,5293,0
MYE,5289,200,22.0900,100,22.0200,22.0600,5238,51
BNED,5287,63,5.0100,100,5.0000,5.0100,5186,101
CRTX,5287,100,32.1600,100,31.5000,31.8600,5287,0
CACC,5285,100,346.0300,152,345.0600,345.6200,5171,114
SPTN,5285,100,17.9300,100,17.7500,17.8700,4685,600
OCFC,5279,100,19.7900,100,19.7100,19.7700,5223,56
CM,5277,100,88.5100,100,88.4700,88.4500,4777,500
ALXO,5275,100,82.3200,2,80.7200,81.2900,5273,2
SPHY,5267,900,26.6200,200,26.6000,26.6100,4513,754
OSH,5265,100,56.5600,100,56.0500,56.3200,4941,324
EBSB,5261,200,15.7000,700,15.6400,15.6700,5261,0
SMB,5256,28,18.1500,2917,18.1300,18.1300,4930,326
INOD,5253,1200,5.5500,100,5.5200,5.5200,5153,100
ASGN,5247,200,90.4400,100,89.9400,90.0200,5237,10
VV,5247,400,180.9600,400,180.9100,180.9100,5062,185
ETON,5242,100,9.2700,100,9.1500,9.2100,5242,0
FPEI,5240,200,20.4000,200,20.3800,20.3700,2540,2700
FPI,5240,300,10.9300,200,10.8500,10.8500,5240,0
CAI,5232,100,35.6400,41,35.3000,35.5200,5232,0
FDS,5231,25,325.9300,100,324.7300,325.7600,4599,632
VIXM,5231,100,38.2500,900,38.1200,38.1400,5031,200
AGT,5230,100,26.2800,600,26.2300,26.2600,930,4300
FINMU,5224,100,10.5500,100,10.4600,10.5000,5224,0
RNLX,5224,100,24.1900,100,23.4900,23.9000,4851,373
AXGN,5217,100,19.2300,22,19.1100,19.1100,5178,39
CUBI,5210,100,22.3400,54,22.1800,22.2200,5209,1
BIP,5209,100,53.4800,100,53.4400,53.4600,4549,660
HNRG,5207,100,1.4700,1200,1.4400,1.4600,3907,1300
ITM,5206,100,51.9600,75,51.9500,51.9550,5206,0
MLPX,5206,2700,29.5500,200,29.5100,29.5400,5106,100
GNOGW,5205,100,8.6300,100,8.4700,8.4700,5170,35
DORM,5191,55,99.2300,400,98.4900,99.1800,5185,6
MTX,5191,98,66.0000,2,65.8300,65.8700,4970,221
ENTA,5190,100,47.0400,100,46.6800,46.7500,5090,100
EQBK,5184,100,23.8000,100,23.4500,23.6800,5184,0
FGNA,5183,100,10.9900,200,10.9000,10.9300,5183,0
VOE,5182,700,123.7600,300,123.7100,123.8200,5082,100
HGLB,5165,100,6.8400,100,6.6800,6.8000,4465,700
PCB,5162,100,12.0000,100,11.7300,11.8700,5162,0
TARO,5160,100,77.7600,109,75.9600,76.6800,4807,353
UFCS,5158,100,30.7100,400,30.5600,30.5800,5158,0
DLB,5151,35,95.0100,2,94.7700,94.8100,4673,478
EXLS,5144,1,85.5600,201,85.4800,85.5500,5144,0
BBCP,5140,100,5.5700,100,5.5100,5.5000,5040,100
BCEL,5140,100,15.2700,100,15.1500,15.2400,5040,100
LSTR,5138,2,153.3500,102,153.2700,153.3300,5138,0
ERC,5137,100,12.2500,100,12.1500,12.1800,882,4255
ZAGG,5127,1150,4.2000,801,4.1900,4.1950,5127,0
HIGA=,5124,100,10.8800,366,10.8400,10.8500,4382,742
URGN,5121,800,21.0000,1,20.8700,20.8900,4492,629
JCOM,5111,100,97.7300,7,97.6200,97.7000,5065,46
LTPZ,5105,100,88.0200,100,87.0800,87.4800,105,5000
BDSX,5104,100,29.7600,100,29.3500,29.5600,4756,348
VRS,5104,10,12.8000,203,12.7400,12.7500,5104,0
B,5103,11,53.5500,100,53.2200,53.4300,5101,2
LMB,5101,100,15.2300,100,15.0100,15.1400,3891,1210
BAMH,5100,100,25.0700,100,24.8300,24.9400,5000,100
ATHE,5098,362,1.7400,100,1.7100,1.7300,5098,0
AB,5093,100,35.9300,204,35.6800,35.6800,5015,78
NAV,5092,100,44.0300,700,44.0200,44.0300,4992,100
IMPX=,5088,400,11.9000,900,11.8000,11.8050,4988,100
GLRE,5086,200,8.2400,100,8.2100,8.2100,5086,0
CASY,5082,100,197.6300,5,196.6900,196.8600,4582,500
SLGG,5081,72,3.4800,200,3.4300,3.4600,5081,0
HJLI,5076,9,8.7500,200,8.6800,8.7100,4876,200
NKTX,5074,35,48.9700,100,48.1900,48.2600,5032,42
ETW,5069,700,9.8200,1600,9.8000,9.8100,5069,0
KJUL,5068,100,26.1500,200,26.0500,26.1600,5068,0
SLP,5058,1,73.6100,33,73.3100,73.3300,5058,0
KZR,5052,100,5.4400,100,5.3900,5.4200,5052,0
IPOS,5050,1100,39.1100,600,38.4700,38.7700,46,5004
DJAN,5046,1400,30.3700,1000,30.3200,30.3600,5046,0
SSD,5046,1,103.3000,1,103.2600,103.2400,4979,67
YRD,5038,100,3.6700,100,3.6100,3.6100,1070,3968
SONA,5033,5,12.5100,200,12.4200,12.4700,5030,3
DMRC,5025,100,40.6300,100,40.1700,40.3700,4825,200
XAN,5025,200,4.3200,100,4.3000,4.3100,4425,600
MIDD,5020,100,138.5000,44,137.2100,137.7100,4788,232
OBLG,5005,1000,4.7500,100,4.6300,4.6700,3854,1151
FCAX=,5001,200,11.0000,500,10.9300,10.9400,5001,0
HZON,5001,200,10.6300,400,10.5800,10.6200,3816,1185
BRLI,5000,100,10.2400,100,10.0600,10.2400,5000,0
BSN+,5000,100,1.4400,100,1.4000,1.4400,5000,0
PIAI+,5000,100,1.8300,100,1.7500,1.8400,5000,0
NSIT,4993,100,81.3600,16,81.2000,81.2600,4992,1
KDNY,4990,110,14.8900,200,14.8500,14.8700,4990,0
JPM-C,4987,100,28.1800,100,27.9000,28.0200,4892,95
LINX,4981,100,7.0300,100,6.9900,7.0100,4981,0
PRLD,4979,100,78.8400,100,77.0000,78.0400,4093,886
DBB,4975,3500,17.4200,100,17.3800,17.3900,3680,1295
BSAC,4972,500,21.9400,200,21.8500,21.8800,4972,0
FTEC,4971,200,107.7700,200,107.7300,107.6500,4571,400
PTVE,4967,100,16.0900,100,15.9900,16.0100,4957,10
BAC-O,4959,100,25.5800,200,25.3000,25.4600,4859,100
OGS,4959,100,71.1600,2,70.8600,70.7700,4958,1
EDD,4954,400,6.2500,300,6.2400,6.2300,2355,2599
CBTG,4942,300,27.8400,500,27.7900,27.8100,2142,2800
ITRN,4942,100,19.0600,100,18.8200,18.9500,2751,2191
ETNB,4936,100,20.9100,100,20.5800,20.7400,4736,200
BHSE,4929,100,10.1600,100,10.1500,10.1600,4929,0
ACIO,4923,6000,28.0300,75,27.9700,28.0000,4923,0
UVV,4923,10,50.0100,100,49.7000,49.9300,4744,179
ITACW,4920,100,1.3400,100,1.2400,1.2400,4420,500
PDFS,4920,100,22.4800,100,22.3000,22.2900,4919,1
PQG,4904,100,15.1400,100,14.9700,15.0650,4888,16
SNMP,4901,600,0.8300,1,0.8000,0.8100,4901,0
BNL,4897,100,18.4200,22,18.3500,18.3500,4897,0
ANY,4886,100,2.0500,100,2.0200,2.0400,4536,350
GIK+,4885,100,4.4600,100,4.3200,4.4000,3885,1000
FRME,4884,176,39.8300,100,39.7500,39.7900,4879,5
INTZ,4883,100,25.1000,100,24.8600,24.9300,4480,403
RYE,4880,800,34.9500,800,34.9200,34.8900,4880,0
FSK,4878,100,17.4100,200,17.3800,17.3900,4526,352
FRBA,4877,400,9.2500,100,9.1400,9.2400,4877,0
PACE,4872,300,11.5300,100,11.3700,11.4100,4872,0
VYMI,4868,200,64.3000,600,64.1500,64.3000,4868,0
BUSE,4864,100,23.0400,5,22.9200,22.9500,4864,0
CNXC,4859,100,119.8900,100,118.5400,119.2100,3888,971
HURN,4858,101,56.0400,50,55.9000,55.9800,4809,49
AMPH,4856,600,18.5000,225,18.3600,18.4000,4756,100
SB,4855,200,1.8500,100,1.8400,1.8600,4388,467
HESM,4853,100,21.6200,100,21.3400,21.4850,4743,110
JFIN,4850,100,3.7000,200,3.6100,3.7000,4850,0
VNTR,4848,1300,4.2300,100,4.1500,4.1900,4848,0
PETQ,4846,2,35.0000,100,34.9100,34.9500,4752,94
VBLT,4846,100,2.5500,100,2.5200,2.5400,4846,0
CXDC,4841,300,1.1200,1200,1.0900,1.1000,4249,592
MPWR,4841,10,402.9800,1,401.8700,402.5300,4723,118
NBR-A,4840,100,8.9400,100,8.8400,8.8500,4440,400
ALACW,4835,100,1.5300,100,1.4700,1.4900,4345,490
SNES,4830,100,2.2100,5,2.1600,2.1200,4830,0
BFT+,4828,100,5.7300,100,5.6500,5.6500,4578,250
CARV,4823,200,7.6000,100,7.4600,7.5700,4623,200
BSQR,4821,100,1.8000,400,1.7500,1.7100,4821,0
PSACW,4820,200,2.3900,100,2.3300,2.3700,4620,200
CURIW,4819,100,7.1800,100,7.0500,7.1200,4819,0
EDEN,4818,1350,99.1900,553,99.1500,99.1600,4818,0
DRD,4816,100,10.7900,100,10.6600,10.7200,4484,332
HNDL,4816,500,25.5000,100,25.4600,25.4800,4816,0
MOO,4816,2000,83.2700,200,83.1400,83.2600,3816,1000
FENC,4804,100,7.8400,100,7.7400,7.8050,4804,0
PLXS,4799,100,80.7700,106,80.2700,80.3100,4536,263
BYFC,4793,100,2.1700,100,2.1400,2.1500,4793,0
SWM,4792,100,41.5900,126,41.4000,41.4000,4773,19
AWR,4787,100,80.5000,2,79.9700,79.9300,4786,1
LMNR,4784,100,16.9100,100,16.7700,16.8500,4384,400
AEFC,4783,100,26.0700,100,25.9100,26.0300,4100,683
PDS,4779,100,21.3900,100,21.3200,21.3100,4379,400
IPA,4768,100,16.3000,100,16.0900,16.2000,4268,500
RNA,4767,20,26.6600,100,26.3700,26.5600,4767,0
UTSL,4755,200,27.3800,100,27.3600,27.3200,4755,0
NXTC,4747,900,12.6400,2,12.5200,12.5400,4747,0
EPIX,4746,100,17.9400,100,17.7100,17.8200,4726,20
GLG,4743,100,2.3300,100,2.2800,2.3200,4413,330
FUN,4740,100,41.6000,100,41.1200,41.4100,4172,568
MEI,4740,200,41.9600,200,41.6200,41.7300,4689,51
DSGX,4737,100,63.0500,100,62.8500,62.8600,4543,194
XAIR,4715,100,6.1100,100,6.0900,6.1000,4251,464
AGLE,4713,300,7.6000,800,7.4800,7.5900,4615,98
VECO,4713,100,20.5800,59,20.4800,20.5300,4471,242
ENZ,4711,300,3.0100,100,2.9800,3.0000,4711,0
CMPS,4709,42,45.0500,100,44.4600,44.7000,4431,278
CABA,4708,100,12.7400,200,12.5000,12.7200,4708,0
BXC,4706,100,38.2300,100,37.6700,38.1700,4486,220
NOAH,4696,2,49.5800,100,49.2700,49.5300,4623,73
PBD,4693,300,40.1900,300,40.0000,40.1000,2854,1839
BCOV,4692,100,18.5100,100,18.4700,18.5000,4692,0
CFO,4683,100,64.3700,4230,64.3200,64.2300,4683,0
CLW,4683,100,41.0300,300,40.6100,40.7900,4443,240
JBT,4679,100,125.0300,2,124.7700,124.8800,4365,314
RAIL,4678,100,3.4800,100,3.3900,3.4400,4537,141
VMI,4678,1,209.9200,100,209.6100,209.8700,4646,32
GER,4659,100,8.6600,513,8.6200,8.6400,3557,1102
RPLA,4659,200,10.2600,450,10.2500,10.2500,4352,307
UEPS,4653,100,5.1200,200,5.1000,5.1100,4553,100
PZA,4651,100,27.0900,100,27.0800,27.0800,4651,0
HFWA,4636,137,25.2700,100,25.2100,25.2100,4635,1
RS,4636,1,125.8200,100,125.6500,125.6800,4409,227
GOOD,4632,26,18.4400,1,18.3900,18.4000,4632,0
DVY,4629,600,100.7400,600,100.7000,100.7200,4473,156
ITGR,4629,1,79.1700,69,79.0100,78.9900,4628,1
BMTX,4628,100,16.2400,100,16.0100,16.0900,4439,189
OSB,4622,100,43.2400,100,43.1700,43.1200,4622,0
FIBK,4621,100,41.7500,100,41.5100,41.5700,4621,0
STIP,4618,95,105.0600,200,105.0500,105.0600,4618,0
VNRX,4618,100,4.0600,800,4.0100,4.0500,4618,0
FN,4615,5,85.3900,1,85.2600,85.4100,4615,0
AHH,4612,100,11.7400,100,11.6500,11.6800,4606,6
LSEA,4611,100,9.9000,100,9.7900,9.9000,4611,0
RCG,4608,300,2.0500,200,1.8400,1.8500,4607,1
FBNC,4604,100,36.0200,100,35.7900,35.9300,4604,0
KALU,4598,2,100.4100,10,99.9800,100.2700,4578,20
TDAC,4596,100,12.2700,200,12.1500,12.1600,4364,232
BATRK,4594,40,25.6900,40,25.6100,25.6700,4494,100
QMCO,4594,100,7.0300,100,6.9500,6.9700,4594,0
DIOD,4591,100,79.9900,219,79.2700,79.6500,4590,1
RYN,4589,300,31.8200,6,31.7400,31.7400,4354,235
QH,4582,100,7.5400,100,7.4200,7.4200,4442,140
MAX,4581,100,42.5900,36,41.7100,41.9500,4471,110
TBK,4580,46,58.9400,100,58.4600,58.5700,4579,1
FNDC,4579,600,36.2700,700,36.0400,36.1400,4579,0
DDWM,4568,1000,28.8600,1000,28.7800,28.8000,4568,0
WD,4568,6,90.2000,28,89.8900,90.0500,4451,117
OM,4565,1,52.3900,100,52.0000,52.3400,4532,33
JPS,4564,400,9.3600,100,9.3500,9.3500,4555,9
IGA,4557,1021,8.9100,200,8.8600,8.8900,2304,2253
ALIM,4545,100,8.7800,300,8.5100,8.5900,4445,100
TPB,4544,200,45.0600,100,44.8700,45.0700,4308,236
SON,4540,300,61.2100,100,61.1300,61.2100,4529,11
MAN,4538,12,95.3500,100,94.9200,95.1400,4443,95
SJW,4536,100,67.2400,100,66.7700,66.6700,4536,0
EWN,4534,600,44.5200,800,44.3300,44.4200,4534,0
OCUP,4530,100,9.6600,100,9.5400,9.8100,4015,515
INBX,4529,408,35.9900,100,34.7600,35.8000,4490,39
CHIX,4523,200,16.8100,410,16.7500,16.7900,4523,0
MOV,4523,100,20.8000,100,20.7500,20.8700,4423,100
FRG,4517,100,32.5300,171,32.4100,32.2200,4517,0
ANPC,4516,200,6.1800,100,6.0200,6.0000,4516,0
EMGF,4514,1100,53.2600,600,53.1400,53.1300,4514,0
SAIA,4514,100,199.0600,115,197.6400,198.0700,4205,309
EIM,4507,100,13.3900,100,13.2800,13.3400,4407,100
KIN,4507,400,4.5000,1,4.4800,4.4900,4507,0
CLMT,4505,100,3.6700,400,3.6100,3.6150,4405,100
CMLF,4505,200,12.0100,100,11.9500,12.0000,4405,100
EEX,4505,100,4.5000,600,4.4400,4.4200,4505,0
IWC,4505,11,133.3200,13,133.1400,133.1600,4500,5
IDEV,4503,800,63.7500,500,63.6700,63.6850,4503,0
BAP,4500,100,154.0100,100,153.2700,153.3300,4451,49
CRY,4500,100,25.1500,100,25.0900,25.0400,4500,0
XMMO,4500,600,84.8200,300,84.7000,84.7600,4500,0
GWW,4496,14,392.8700,3,392.4600,392.6400,4410,86
EIG,4493,100,32.6100,100,32.3700,32.4500,4493,0
MSOS,4490,500,45.6200,379,45.5000,45.4100,4090,400
WISA,4484,100,3.7600,100,3.6600,3.6950,4484,0
AVCTW,4482,100,0.8000,200,0.7600,0.8000,4382,100
CWT,4480,200,54.1100,14,53.8200,53.7800,4269,211
JBGS,4475,5,31.3900,33,31.3400,31.3700,4373,102
BIL,4465,490850,91.5200,458050,91.5100,91.5150,4465,0
PROF,4452,100,26.2400,100,26.1500,26.3300,4098,354
SFTW+,4450,100,1.9700,100,1.8600,1.9000,2470,1980
HMN,4446,100,43.1600,100,43.0500,43.1100,4349,97
RMAX,4445,3,39.3200,100,39.0400,39.1500,4445,0
JOF,4441,100,9.1500,100,9.0600,9.0000,2467,1974
WFC-W,4439,100,25.4700,100,25.2300,25.3500,1196,3243
KE,4436,100,17.9400,100,17.7300,17.8700,4436,0
CSGP,4435,1,912.0300,1,906.3000,908.9500,4330,105
LINC,4433,100,6.3000,300,6.1500,6.2600,4433,0
CODI,4431,200,21.4100,100,21.2700,21.4600,3998,433
NRIX,4417,100,44.2700,100,43.9300,44.2600,4417,0
IJS,4402,700,88.5900,300,88.5000,88.5000,4402,0
AACQU,4400,100,11.8400,900,11.8000,11.7500,4200,200
PRPB,4398,200,10.7300,1320,10.6700,10.6800,4398,0
NCNA,4396,100,6.4200,100,6.3100,6.3500,4386,10
ASUR,4390,100,8.0300,100,7.9800,8.0100,4290,100
MORT,4387,1600,17.2100,200,17.1900,17.1800,3787,600
TOKE,4383,600,18.5700,100,18.2600,18.5200,4383,0
UJUL,4377,300,26.5300,300,26.4500,26.4600,4377,0
VMD,4370,96,8.7100,100,8.6700,8.7100,4262,108
GNR,4356,500,48.3600,600,48.3000,48.2000,4256,100
KT,4356,400,10.8700,700,10.8600,10.8600,4356,0
NBTB,4351,100,34.3900,12,34.3000,34.4100,4351,0
BAR,4349,22400,18.5800,22200,18.5700,18.5800,4349,0
EELV,4349,300,22.8700,200,22.6600,22.7100,4349,0
CLAS=,4347,200,11.0000,100,10.9300,11.0000,3447,900
CW,4339,100,116.7500,5,116.1300,116.2700,4339,0
ARD,4337,100,17.9400,100,17.7400,17.8800,3473,864
BANF,4334,41,63.2100,1,63.0500,63.1500,4210,124
VOLT,4331,200,2.8700,200,2.8400,2.8600,4331,0
EXP,4328,200,114.5100,2,114.3000,114.3100,4280,48
TPOR,4318,300,27.8500,100,27.7800,27.7600,3345,973
ALGT,4314,57,191.3700,133,190.7700,191.2400,4201,113
CMBM,4314,100,31.8100,100,31.3800,31.5100,4224,90
REGL,4311,600,64.7500,500,64.7100,64.7000,3711,600
FAUG,4300,6300,35.1800,2700,35.0800,35.0800,4100,200
PDAC+,4300,500,2.9000,100,2.8400,2.9000,4300,0
AEHL,4299,100,2.8100,200,2.7500,2.8300,4299,0
AEF,4289,100,8.8000,1000,8.7300,8.7300,4089,200
EVOK,4285,1300,2.9200,300,2.8500,2.8300,3885,400
LYTS,4270,100,9.7300,100,9.6000,9.6400,4270,0
SVACU,4269,100,11.4000,100,11.3000,11.2800,2869,1400
GROW,4267,100,5.0500,100,4.9900,5.0500,3292,975
NEA,4266,1100,15.0400,200,14.9800,14.9900,4266,0
TOMZ,4266,100,4.9600,200,4.7800,4.9000,4266,0
HUBB,4265,100,165.7900,100,165.1600,165.2100,3774,491
TR,4262,94,29.8300,100,29.7600,29.8600,4258,4
DLTH,4261,200,12.4600,10,12.3800,12.4300,4261,0
CPSI,4260,100,30.6100,100,30.1900,30.6100,4260,0
GBS,4259,100,7.9000,200,7.7900,7.8500,4259,0
ACIU,4253,1100,6.0900,120,6.0200,6.0600,4253,0
EGBN,4250,100,44.4400,44,44.2400,44.3100,4249,1
ALPN,4247,100,12.6500,100,12.5000,12.2800,4246,1
ORN,4246,900,5.9900,1000,5.9100,5.9350,3792,454
MGTX,4245,100,15.5200,100,15.3200,15.4600,4245,0
EVBG,4238,4,145.2400,1,145.0000,144.9200,4238,0
ROG,4238,100,166.0500,13,164.8200,165.1800,4214,24
C-S,4228,110,25.3800,1715,25.3700,25.3700,4228,0
EMX,4228,200,3.6000,200,3.5600,3.5600,4028,200
NISN,4222,100,22.4200,100,22.2000,21.9700,4222,0
VTWO,4221,2600,172.2900,90,172.1600,172.1900,3921,300
FELE,4216,102,72.3600,100,72.0200,72.3000,4216,0
FDP,4213,100,24.7700,100,24.6900,24.6900,4005,208
PHO,4211,200,48.5200,100,48.5000,48.4800,4011,200
CUB,4209,300,66.2300,100,65.5100,65.8700,4206,3
APVO,4207,200,33.0000,100,32.6300,32.7500,4134,73
NGE,4207,400,12.7200,400,12.5700,12.5000,2560,1647
AOK,4205,200,39.0900,300,39.0500,39.0800,4205,0
KMDA,4201,100,6.8200,100,6.7700,6.8300,4001,200
SCE-H,4198,100,24.4500,100,24.2600,24.3500,2672,1526
TDW,4197,100,10.9800,100,10.9400,10.9500,4197,0
EQ,4196,100,5.8300,100,5.6600,5.7400,4196,0
CCU,4195,100,16.7200,200,16.5500,16.6400,3556,639
HLI,4192,100,71.0100,2,70.8400,70.8800,3791,401
DOMO,4189,3,71.3200,54,71.1800,71.3600,4164,25
DFNS,4182,100,10.9400,100,10.7800,10.8700,4182,0
BIO,4178,100,590.3600,1,589.2500,589.7500,3847,331
MMLP,4177,100,1.9400,100,1.8700,1.8800,4062,115
CTEC,4175,1000,27.9900,300,27.8000,27.9400,3499,676
HAIN,4173,200,39.9800,100,39.8500,39.8500,3948,225
IBTX,4173,100,66.1300,5,66.0200,66.0200,4152,21
PIAI,4171,100,10.5200,100,10.4300,10.4500,1171,3000
EPAY,4170,1,52.2000,7,52.0200,52.0600,4170,0
AIT,4167,100,83.4200,30,83.0000,83.1100,4059,108
CTBI,4167,100,39.1900,100,38.7100,38.9900,4167,0
KRTX,4154,100,101.8300,43,100.9200,101.2200,4152,2
SAR,4154,100,23.5100,200,23.2800,23.4400,4154,0
MLND,4150,200,1.8900,300,1.8700,1.8800,3850,300
PEN,4150,100,246.6800,2,245.4500,245.5300,4130,20
LFTRU,4144,100,11.5000,100,11.4400,11.4900,3044,1100
IMNM,4139,100,14.4200,20,14.1000,14.1800,4139,0
FLUX,4135,400,18.7800,100,18.5900,18.6400,3922,213
CENT,4132,100,42.0600,43,41.9900,42.0500,4132,0
EVER,4131,54,40.1900,100,39.8700,39.8900,4131,0
PSTL,4117,1,16.1500,28,16.1300,16.1300,3921,196
FNDX,4115,300,47.4800,3790,47.4600,47.4700,4115,0
BWXT,4112,100,58.4100,22,58.2000,58.2500,3879,233
VICR,4109,200,99.6000,100,98.7600,98.9200,4093,16
AZBJ,4100,200,26.7700,200,23.6300,25.1100,4100,0
PXI,4100,1100,20.4400,800,20.4100,20.4000,4100,0
PRSRU,4096,100,11.5200,200,11.4100,11.4800,3956,140
MCFT,4095,100,29.1400,100,28.9000,29.0600,4095,0
ACRE,4093,100,11.9300,100,11.8400,11.8700,4093,0
CGBD,4088,100,11.2400,101,11.1800,11.1700,4043,45
VTC,4088,1000,92.9600,200,92.9200,92.9500,1888,2200
MSBI,4083,100,19.5700,200,19.4100,19.5300,4083,0
ULH,4082,100,23.2000,100,22.8900,22.9250,4082,0
AIRC,4079,200,39.3700,300,39.2300,39.3900,3999,80
BMTX+,4077,100,3.9200,100,3.7600,3.9700,3977,100
GDYN,4077,200,12.9000,100,12.8400,12.9100,4077,0
MPV,4077,100,12.4300,76,12.2000,12.2000,4077,0
PSP,4076,400,13.8900,900,13.8400,13.8700,3776,300
MCAC,4073,100,11.4900,100,11.3600,11.4900,3973,100
ALVR,4069,100,45.5100,100,44.8700,44.9000,4062,7
CNOB,4068,205,21.2800,54,21.1800,21.0200,4068,0
HNI,4064,1,34.4900,5,34.4200,34.4200,4060,4
MHN,4064,100,14.2000,100,14.0700,14.1200,3476,588
NGA=,4063,600,33.8400,500,33.3100,33.5300,3621,442
FOXF,4061,100,127.3800,100,127.2000,127.3600,4061,0
FF,4060,100,14.0300,100,13.9300,13.9300,3960,100
AVUV,4057,2000,62.6500,2000,62.6000,62.6000,4057,0
TTEC,4054,30,77.8700,100,77.6800,77.6900,4054,0
STTK,4050,5,46.7700,100,46.0200,46.3100,3829,221
VCEB,4046,2600,75.1100,150,75.1000,75.1100,4046,0
HCM,4045,100,33.3400,100,33.2300,33.2950,4045,0
THBRW,4038,100,3.4500,100,3.3300,3.4000,3593,445
VIHAW,4037,100,4.0400,100,3.9000,3.9400,3985,52
WSBC,4035,100,31.1000,100,31.0400,31.1300,4035,0
JQC,4033,600,6.4400,200,6.4300,6.4350,4033,0
SPAK,4031,800,30.6400,1000,30.5700,30.5900,3105,926
CNXN,4025,200,52.3800,119,52.1700,52.2200,4025,0
DMLP,4017,100,12.9400,100,12.8000,12.7600,4017,0
PXH,4014,400,22.6700,300,22.6600,22.6600,4014,0
ARCB,4009,4,49.0600,1,49.0100,49.0400,4000,9
HRI,4008,85,70.9200,100,70.5800,71.0000,4002,6
GCP,4005,106,24.6900,100,24.6500,24.6500,3885,120
VIE,4005,100,34.4500,100,33.8600,34.1600,4005,0
FEM,4000,100,27.2900,400,27.2000,27.2500,3900,100
JEPI,4000,1000,56.2900,600,56.2200,56.2200,4000,0
PEZ,4000,500,86.9900,500,86.5400,86.8000,4000,0
IVC,3994,297,9.9600,100,9.8900,9.9700,3993,1
BUYZ,3992,900,56.4300,1500,56.3500,56.3600,3992,0
FWRD,3992,5,80.6600,100,80.0600,80.5600,3970,22
NEXT,3988,100,2.7100,700,2.6800,2.7000,3938,50
MX,3986,100,18.1200,100,18.0300,18.1000,3627,359
MDIV,3982,200,15.3400,300,15.3000,15.3200,3982,0
QQQM,3974,200,134.2500,600,134.1900,134.2100,3783,191
DBJA,3970,100,25.8700,100,25.7300,25.8000,3970,0
IQDG,3966,1000,38.1000,1042,38.0700,38.0900,3766,200
MODV,3965,9,167.3800,100,165.9000,167.2700,3835,130
SFHY,3965,4300,49.4700,342,49.4300,49.4300,3965,0
CBSE,3960,1000,26.1700,1000,26.1200,25.9900,3960,0
EFNL,3959,700,46.7100,1200,46.5600,46.6800,3959,0
FULC,3956,400,13.9700,9,13.7500,13.6700,3916,40
PSTV,3954,1100,2.4000,100,2.3000,2.3200,1854,2100
PHG,3952,5,55.3100,100,55.1900,55.1800,3694,258
OFG,3949,100,19.4800,48,19.2800,19.3700,3949,0
BCPC,3947,100,118.6200,5,117.9600,117.9700,3828,119
INGN,3947,100,46.8600,100,46.4300,46.9400,3947,0
CXSE,3946,1000,74.2800,1000,74.1700,74.2450,3946,0
AZPN,3942,100,144.1700,100,143.8100,143.9800,3834,108
COR,3939,1,125.9900,100,125.4700,125.9200,3938,1
SCHO,3939,83400,51.4000,86600,51.3900,51.3950,3939,0
SVOKU,3931,100,10.9400,100,10.8200,10.8200,3881,50
ABG,3928,3,169.6300,100,168.4500,168.9800,3912,16
EVC,3923,1000,3.1600,700,3.1300,3.1200,3823,100
SKF,3913,1400,15.1200,700,15.1100,15.0850,3913,0
AMED,3898,100,303.0500,100,300.3900,302.1000,3868,30
NURO,3889,100,3.9900,2200,3.9800,3.9800,3889,0
SEER,3889,15,83.2400,100,82.6900,82.9700,3651,238
BASI,3886,200,14.9500,100,14.7800,14.8800,1989,1897
SLNO,3886,1100,2.1100,200,2.0800,2.1000,3166,720
TNET,3878,1,81.4400,100,81.3500,81.3600,3878,0
FREE,3872,100,12.0700,100,11.9800,12.0200,3872,0
GGZ,3868,100,13.2700,100,13.1200,13.2000,300,3568
ZBRA,3863,57,406.4100,5,406.0300,406.1400,3676,187
GFX=,3860,100,11.0200,100,10.9100,10.9800,3860,0
MDYG,3860,300,74.4900,200,74.4400,74.4500,3860,0
FPAC+,3850,100,2.3800,100,2.2800,2.3500,3650,200
SILC,3847,100,45.4600,400,44.6300,44.7200,2870,977
FLOW,3830,100,55.8400,100,55.3100,55.5600,3830,0
LOGC,3828,200,8.4900,100,8.4300,8.4500,3821,7
SNX,3826,41,91.5600,200,91.1000,91.1500,3825,1
SALT,3822,100,17.6400,100,17.4800,17.6300,3495,327
ASLN,3821,100,2.1900,500,2.1400,2.1500,3721,100
ISIG,3821,100,8.7600,100,8.5300,8.5900,3475,346
SRCE,3819,100,41.7800,105,41.6800,41.6900,3819,0
PGC,3816,15,25.5100,105,25.4200,25.4700,3713,103
GNSS,3811,100,7.8800,200,7.7700,7.8700,3811,0
GLSI,3801,100,37.0800,300,36.3800,36.6950,3304,497
BML-L,3800,400,24.9000,100,24.8000,24.9300,3800,0
GSL,3792,100,15.0400,100,14.8700,14.8350,3792,0
VONV,3792,200,123.8800,200,123.8500,123.8600,3292,500
MMIN,3785,300,27.6500,500,27.6000,27.6300,1298,2487
ETV,3776,600,15.2000,200,15.1600,15.1700,3776,0
GEF,3776,10,49.5800,100,49.5100,49.5500,3608,168
IBCP,3773,100,19.9900,22,19.9600,20.0000,3773,0
EMO,3770,100,15.6100,500,15.5100,15.5000,224,3546
VOOG,3769,500,237.1700,500,237.1000,236.8700,3636,133
VRCA,3763,100,11.8600,100,11.6600,11.8000,3763,0
ATHM,3760,100,108.5200,200,108.2700,108.2700,3756,4
XTNT,3756,600,1.5700,600,1.5200,1.5000,3756,0
BHE,3755,100,27.3600,500,27.0900,27.2700,3754,1
IYLD,3755,71,24.0000,100,23.9900,24.0100,3755,0
MTSL,3747,100,3.2000,100,3.1200,3.1600,3747,0
EEFT,3745,100,141.1000,100,139.9200,140.5800,3644,101
SOYB,3743,400,20.3800,1000,20.3400,20.3500,3443,300
SMG,3740,46,226.8200,2,226.5600,226.8400,3683,57
CANG,3731,100,8.6400,100,8.4700,8.5750,3640,91
LXFR,3729,300,17.0500,5,16.8500,16.8200,3647,82
SFET,3728,100,1.6600,100,1.6000,1.6500,3728,0
SOLY,3727,100,9.7900,100,9.6600,9.7800,3627,100
OUSA,3725,1000,38.5000,7000,38.4800,38.5000,3724,1
CGROW,3724,100,3.5300,100,3.4200,3.4900,3724,0
EPRF,3723,900,24.3600,26,24.3200,24.3250,3723,0
TDG,3721,100,573.9200,7,573.2900,573.2900,3613,108
EAD,3719,200,8.1800,200,8.1700,8.1700,3702,17
FDG,3706,1000,77.1600,1000,77.0700,77.1350,3706,0
LNFA,3706,200,10.3300,100,10.2400,10.3100,3612,94
APLT,3697,100,20.5400,200,20.2800,20.3100,3697,0
IVAN=,3691,100,11.4400,100,11.3500,11.3400,3691,0
BURL,3688,100,255.9300,100,254.2700,255.0600,3654,34
FISI,3688,100,24.5000,15,24.3400,24.4000,3688,0
IGD,3687,200,5.3800,400,5.3700,5.3750,3487,200
SGLB,3679,100,4.0400,3,3.9800,3.9700,3479,200
CSL,3674,44,153.9600,7,153.8100,153.9300,3560,114
IIIV,3674,200,29.4100,93,29.2900,29.2600,3670,4
ARW,3670,31,107.7400,1,107.3900,107.3800,3670,0
BWB,3670,100,13.2200,179,13.1900,13.1900,3670,0
BJAN,3669,6800,33.3100,6587,33.2500,33.2600,3669,0
DWIN=,3662,100,10.4100,100,10.3300,10.4800,3075,587
EOSEW,3660,100,10.8500,100,10.7600,10.5000,3160,500
WEX,3654,100,203.9700,14,203.0300,203.0500,3539,115
SBCF,3645,406,32.7800,2,32.6200,32.7300,3641,4
AJX,3644,100,10.7200,200,10.6400,10.5900,3644,0
SIGA,3641,100,7.1400,100,7.0900,7.0800,3641,0
IMPX,3637,400,10.9300,100,10.8500,10.8650,3470,167
UUU,3637,100,5.5900,10,5.4800,5.4800,3387,250
BIOX,3634,100,8.0400,100,7.8600,8.0000,2431,1203
FOCS,3633,3,51.2300,100,50.9500,51.1000,3560,73
IMUX,3633,100,16.9100,100,16.7600,16.9200,3200,433
SCSC,3633,100,26.9100,100,26.5100,26.6900,3633,0
GNPK=,3631,100,11.5400,100,11.4400,11.5000,3331,300
GNOM,3623,500,26.0300,300,25.9300,26.0100,3623,0
RLI,3620,2,100.9900,15,100.7800,100.9800,3552,68
XSHQ,3619,300,34.9100,300,34.7900,34.8200,3619,0
HCKT,3618,100,14.5800,100,14.4600,14.5300,3518,100
KRNT,3616,100,97.6900,100,96.7000,97.1800,3014,602
AIN,3614,5,76.9900,100,76.7400,76.9400,3476,138
SSNT,3614,100,4.2900,100,4.1100,4.1900,1114,2500
IDN,3613,200,11.7900,92,11.7500,11.7900,3191,422
NDP,3613,100,15.3000,200,15.1800,15.1800,1489,2124
ICFI,3611,49,81.2600,100,80.6700,81.0500,3611,0
TRC,3606,200,16.2000,100,16.1000,16.1800,3594,12
SBIO,3605,24,55.8900,24,55.7900,55.7900,2632,973
MXF,3600,100,14.0700,500,13.9000,14.0500,1100,2500
PLUS,3599,100,92.6100,110,92.1000,92.1700,3559,40
HMST,3596,44,36.3100,8,36.2300,36.2800,3595,1
SIC,3593,100,8.2600,100,8.1300,8.1800,3593,0
HMLP,3582,100,15.8600,70,15.7300,15.7300,3582,0
ESE,3577,139,105.6100,39,105.0000,105.6200,3577,0
IMKTA,3576,100,43.5500,100,43.0800,43.2900,3576,0
MGRC,3575,100,72.7900,49,72.3800,72.3900,3575,0
CIA,3572,300,5.9600,1,5.8700,5.9600,3572,0
STXS,3567,118,4.9600,100,4.9100,4.9600,3567,0
BMTC,3562,100,33.3700,1,33.2000,33.2400,3468,94
ESSC,3559,55,10.1000,900,10.0800,10.1100,3559,0
BCYC,3558,100,27.0000,100,26.4700,26.3800,3525,33
CIICW,3556,100,9.6900,100,9.5900,9.7100,2996,560
KREF,3552,100,17.9300,600,17.8800,17.8800,3551,1
RPTX,3552,9,39.2900,100,38.7500,39.5200,3447,105
GECC,3545,50,3.2400,1,3.2200,3.2400,3273,272
SPFF,3544,300,11.9000,1600,11.8800,11.9000,3229,315
ECOLW,3543,100,7.4900,100,5.5700,5.8100,3543,0
LNDC,3539,100,11.7700,3,11.7100,11.7400,3539,0
MANT,3539,100,98.1300,100,97.9300,98.0300,3449,90
SCHL,3536,100,26.5000,400,26.3300,26.4800,3536,0
HYMB,3533,300,59.6300,100,59.6000,59.6200,3533,0
LOCO,3531,100,20.0500,1,19.9700,19.9700,3531,0
USEP,3530,365,27.2400,8600,27.1900,27.2000,3530,0
PFBI,3525,45,15.4500,100,15.1600,15.4100,3525,0
FOXWU,3524,100,10.4400,100,10.3500,10.3600,2224,1300
IDXX,3523,10,495.6500,100,495.0200,495.1600,3382,141
SPYX,3521,300,95.1600,300,95.1100,95.1500,3521,0
TFFP,3520,100,18.9500,500,18.6800,18.7600,3494,26
NTST,3518,100,17.8500,100,17.7000,17.6950,3408,110
VVOS,3518,100,7.0100,100,6.8100,6.9000,2618,900
FHLC,3517,1834,60.6100,200,60.5700,60.6000,3315,202
MCY,3514,1,53.7400,100,53.4400,53.6900,3469,45
EPM,3511,165,3.0800,200,3.0600,3.0800,3402,109
PIM,3508,100,4.1900,100,4.1500,4.1900,0,3508
PXJ,3507,1100,3.2200,1100,3.2100,3.2400,3507,0
FRA,3503,1,12.7200,300,12.7100,12.7100,3403,100
OYST,3502,100,19.5100,100,19.0700,19.4500,3502,0
WPF+,3500,100,2.9200,100,2.8100,2.8450,3400,100
HALL,3499,11,3.5600,200,3.4800,3.5100,3499,0
ASPN,3491,100,19.0300,100,18.9200,18.9400,3491,0
PAR,3491,100,71.6900,100,71.0900,71.5200,3373,118
NUMG,3489,500,50.8100,625,50.7500,50.7700,3489,0
LSI,3488,1,121.0800,100,120.6500,121.0600,3485,3
KMPR,3487,100,76.0400,100,75.8400,75.8600,3487,0
BWX,3477,230,31.0600,200,31.0300,31.0500,1846,1631
IPAR,3475,100,61.8900,100,61.7000,61.8400,3475,0
SBT,3475,100,5.1100,265,5.1000,5.1000,3275,200
HUIZ,3474,100,6.6400,100,6.4700,6.5800,3474,0
SCHV,3473,5120,61.3700,900,61.3500,61.3800,3473,0
SRAX,3473,1000,3.1400,100,3.0700,3.0500,3473,0
MLR,3471,6,41.2400,100,40.7000,40.9000,3471,0
NCZ,3471,2100,5.1100,600,5.1000,5.1050,3471,0
BCEI,3469,100,22.4100,400,22.3100,22.3700,3469,0
WLDN,3469,200,50.1700,4,49.9200,50.1000,3432,37
MTP,3465,500,2.4500,600,2.4100,2.4350,3465,0
BLX,3461,100,15.5100,200,15.4400,15.4500,3161,300
BWMX,3456,100,38.1600,100,37.4100,37.9700,3456,0
DTEC,3454,3000,48.7000,500,48.5900,48.6600,3348,106
GLQ,3453,100,15.0100,200,14.9100,14.9400,3453,0
FBCV,3451,100,25.1000,50,25.0600,25.0700,3451,0
PLTM,3448,1000,11.2000,1000,11.0800,11.0800,2948,500
NMM,3447,100,13.8800,200,13.7500,13.5500,3337,110
LEE,3445,100,1.4000,200,1.3800,1.4000,3145,300
IFN,3443,100,20.9200,500,20.7900,20.9000,100,3343
GVP,3442,800,1.8300,300,1.8000,1.8200,3242,200
UVSP,3434,100,23.2000,77,23.1500,23.1800,3434,0
PRAX,3432,100,55.5800,101,54.2600,54.3300,3432,0
JPM-D,3429,100,27.8700,100,27.6200,27.7200,3429,0
FCCO,3426,100,16.8000,60,16.5100,16.6000,3426,0
MGPI,3421,5,52.5200,100,52.1700,52.4200,3385,36
SYKE,3415,14,40.9400,189,40.8600,40.9100,3395,20
LOPE,3413,100,89.9100,4,89.4800,89.4900,3382,31
VVR,3411,900,4.1700,955,4.1600,4.1600,3411,0
BRPAR,3409,200,2.0000,100,1.8700,2.0000,3009,400
KOR,3402,1000,2.3000,200,2.2800,2.2900,3202,200
TYL,3402,12,429.0300,13,428.4500,428.5200,3368,34
VCKAU,3400,1100,10.3600,100,10.3100,10.3700,3400,0
UVE,3398,100,15.6600,100,15.4900,15.5600,3397,1
FEI,3393,200,6.4200,100,6.3300,6.3800,1500,1893
LITB,3391,200,2.5500,200,2.4800,2.5500,3391,0
AMWD,3390,11,98.9700,100,98.4700,98.4800,3390,0
CR,3390,100,81.9700,6,81.6700,81.7100,3239,151
BAC-K,3388,100,27.3700,100,27.2600,27.3550,2691,697
HTLF,3388,100,45.2000,100,44.7900,44.9900,3388,0
AUVI,3386,100,5.1100,100,5.0200,5.0600,3347,39
TCMD,3385,1,52.2400,100,52.1200,52.1900,3375,10
IYG,3384,100,154.3100,100,154.2700,154.2300,3084,300
DRSK,3382,6000,29.4900,500,29.4600,29.4800,3285,97
ANCN,3380,100,2.7100,100,2.6200,2.7000,1660,1720
BFT=,3377,100,20.5700,900,20.3300,20.0000,2835,542
FWONA,3374,108,37.0000,100,36.6800,36.9200,3374,0
RTPZ,3369,100,12.2800,200,12.0600,12.2400,3089,280
GLT,3365,15,18.5200,600,18.3900,18.5100,3364,1
TFSL,3362,249,18.9800,135,18.9400,18.9700,3212,150
IEV,3361,300,49.4600,200,49.4300,49.4200,3161,200
BOH,3359,2,82.7700,24,82.6900,82.7400,3250,109
THG,3358,15,119.9000,20,119.7500,120.0400,3296,62
FUTY,3356,1500,40.8200,1700,40.8000,40.8100,2756,600
STOK,3352,100,68.4800,12,67.9900,68.0000,3239,113
HFRO,3350,1199,10.2000,100,10.1400,10.1800,3350,0
CNRG,3333,100,141.4300,200,141.2500,141.3400,3333,0
LCII,3326,91,143.6200,8,143.1000,143.1400,3326,0
ADIL,3321,100,2.2000,1300,2.1400,2.1700,2821,500
KYMR,3320,100,77.2300,300,76.1700,76.5000,3216,104
GTS,3304,35,24.3300,300,24.1900,24.2700,2924,380
CLAR,3303,79,15.7400,200,15.7100,15.7400,3220,83
IDRV,3303,1000,47.5800,13,47.3800,47.3950,1803,1500
NHF-A,3303,100,22.7900,100,22.5200,22.5500,204,3099
ACTCU,3301,100,30.6200,500,30.4900,30.4600,3197,104
VHAQ=,3299,100,10.5800,100,10.4400,10.4900,3299,0
DUG,3297,900,22.4700,900,22.4500,22.2500,3297,0
SZC,3294,200,41.2100,100,40.3500,40.4800,1380,1914
ARA,3291,700,11.4900,500,11.4800,11.4800,3291,0
OXSQ,3291,200,3.5300,510,3.5100,3.5200,2974,317
FXL,3290,200,117.8800,1500,117.8100,117.7800,3290,0
VFH,3289,700,76.0000,600,75.9600,76.0400,3189,100
FRBK,3288,300,2.8900,100,2.8700,2.8800,3288,0
SRI,3274,72,29.5900,100,29.3800,29.5500,3274,0
VCRA,3267,100,45.0000,100,44.7300,44.9350,3167,100
HLNE,3262,100,82.4900,1,82.2300,82.2500,3147,115
HSTM,3260,100,25.0400,100,24.9700,25.0000,3248,12
MSGM,3254,200,28.8700,5,28.5000,28.5900,3047,207
OMFL,3254,6250,42.5500,500,42.5200,42.5100,3254,0
NTP,3250,200,7.0500,100,6.9800,7.0500,3250,0
TLMDW,3249,400,1.2600,200,1.2000,1.2200,3249,0
TIPT,3248,100,5.1000,100,5.0700,5.0900,3248,0
AKUS,3247,100,17.1200,80,16.9100,17.0400,3247,0
CSU,3247,100,28.1300,100,25.9100,27.9500,2257,990
NOVSW,3243,200,10.0000,100,9.6200,9.8000,3043,200
FURY,3238,1700,1.3900,200,1.3800,1.3850,3238,0
DMAC,3236,100,9.0100,100,8.8800,8.9350,3236,0
FARM,3234,100,5.7800,100,5.7500,5.7700,3234,0
LOV,3234,100,6.3300,6,6.2600,6.2700,3234,0
AFG,3226,1,86.5900,100,86.3700,86.7500,3042,184
PBIP,3224,200,12.1700,100,11.9100,12.1000,3224,0
CRI,3223,100,100.6300,28,100.2700,100.5150,3120,103
MYRG,3222,100,64.8200,100,64.0200,64.3500,3150,72
SITM,3219,100,136.1600,100,134.3200,134.9600,2932,287
GPM,3217,100,6.7600,200,6.6700,6.7100,404,2813
TAOP,3216,200,3.2700,200,3.1600,3.2300,3216,0
DCO,3215,100,57.8400,17,57.0700,57.5400,3184,31
PTR,3212,85,34.0800,22,34.0300,34.0500,3106,106
ONEW,3209,100,33.6500,39,33.2100,33.2800,2947,262
NTB,3206,100,33.4700,300,33.2800,33.4300,3206,0
ENR,3199,200,48.1700,53,47.8800,48.0000,3198,1
MOSY,3197,1600,2.9500,1727,2.8500,2.9000,3197,0
JUPW,3195,100,5.7100,100,5.6200,5.6700,3190,5
CLPT,3191,100,20.0000,100,19.6100,19.9100,2990,201
VONG,3190,100,255.1800,100,255.0900,255.0600,3130,60
UMH,3184,100,15.4400,100,15.2800,15.3600,3135,49
ACH,3180,100,8.9600,389,8.9100,8.9300,3036,144
PHD,3174,100,10.7600,100,10.7000,10.7600,2299,875
MGTA,3171,148,8.2200,200,8.1500,8.1900,3171,0
GHIVU,3168,100,12.1300,600,11.8600,11.8900,3168,0
CERE,3165,100,14.0500,100,13.9100,14.0000,3065,100
BSTZ,3164,100,37.1800,200,36.9800,37.0100,1208,1956
CHFS,3162,200,8.7600,100,8.6300,8.6100,2862,300
POWL,3161,100,30.8600,100,30.4900,30.6900,3130,31
FSEP,3159,1000,32.6100,1000,32.4800,32.4700,3159,0
SLQD,3159,1662,52.1600,400,52.1500,52.1550,3159,0
WNW,3155,100,22.7900,72,22.5000,22.5800,3115,40
MDYV,3149,100,58.7300,500,58.6900,58.7200,3149,0
THCX,3147,800,17.6400,800,17.4400,17.5700,2854,293
CEY,3146,100,23.0200,100,22.9600,23.0200,3146,0
USL,3145,4500,18.5400,6500,18.5100,18.5400,3145,0
HYMC,3143,100,7.1700,100,7.1200,7.1500,3143,0
SSKN,3137,400,1.8800,200,1.8500,1.8700,3137,0
BAB,3136,200,33.3700,400,33.3300,33.3500,3036,100
LEU,3133,100,21.9800,100,21.8000,21.8000,3015,118
AEGN,3132,100,20.5100,100,20.3800,20.3900,3128,4
JHMM,3111,300,47.1700,800,47.1400,47.1500,3111,0
RRGB,3110,78,25.2400,3,25.0300,25.1300,3110,0
ARC,3107,200,1.9600,200,1.9400,1.9700,3102,5
HUBG,3104,3,59.9700,9,59.7700,59.8800,3103,1
ASND,3103,100,155.6700,6,154.6900,154.8300,3067,36
INDB,3103,100,79.3000,46,78.9000,79.1500,2722,381
ACEL,3100,100,10.5700,100,10.5400,10.5500,2659,441
ALTUU,3100,100,10.7100,100,10.5500,10.6000,3100,0
BTAQW,3100,100,3.2400,100,3.1100,3.1400,3100,0
DLN,3100,300,109.4600,200,109.4400,109.4700,3100,0
GWACW,3100,100,1.3900,100,1.3100,1.3800,3100,0
MTL,3100,1800,1.9700,50,1.9500,1.9700,3100,0
ECOL,3098,200,36.1500,100,35.9600,36.1200,3097,1
EIGI,3097,2800,9.4800,5828,9.4700,9.4750,3097,0
SGRP,3090,900,1.3800,33,1.3400,1.3350,3090,0
SYLD,3090,300,49.8500,100,49.6000,49.9000,3090,0
UJAN,3081,900,30.1000,600,30.0000,30.0250,3081,0
GPRK,3075,100,12.6900,100,12.6000,12.6200,3075,0
BOAC,3072,200,11.2700,67,11.2400,11.2700,2952,120
GRTX,3071,200,12.0600,100,11.9000,11.9800,3071,0
PJT,3068,100,79.6000,100,79.0200,79.3400,2879,189
VEC,3067,100,54.1900,100,53.9400,54.2900,3067,0
COLM,3059,100,92.1400,100,91.4800,91.7700,2898,161
FBK,3058,28,36.2800,100,36.1800,36.0700,2927,131
PNTG,3054,100,60.6800,100,59.8400,60.3900,3001,53
FAMI,3047,900,1.3600,1400,1.3200,1.3300,3047,0
IFRX,3045,1100,5.7200,200,5.6200,5.6500,3045,0
DGS,3043,100,49.2600,200,49.1600,49.2050,3021,22
EWUS,3040,1300,43.5500,1000,43.4500,43.4600,3040,0
DFAU,3038,100,27.2700,200,27.2400,27.2400,3038,0
HOFT,3036,100,32.7600,100,31.9300,32.1200,2953,83
LKFN,3033,300,60.3100,100,59.8700,60.2600,2925,108
PREF,3030,100,20.7100,300,20.6900,20.6900,3030,0
TEAF,3026,200,13.4400,100,13.3700,13.4200,2514,512
TACO,3023,200,10.0300,200,10.0000,9.9700,2804,219
CPS,3022,100,37.5700,100,37.1200,37.4500,3022,0
CHW,3018,100,9.9000,100,9.8300,9.8800,2318,700
QDF,3013,3780,51.0700,2980,51.0300,51.0200,3013,0
IBHC,3012,220,24.5600,252,24.5200,24.5000,3012,0
CCCC,3011,100,37.2600,138,35.8700,36.5100,3010,1
BOWXW,3004,100,2.2800,100,2.1700,2.1900,2804,200
DWSH,3001,300,10.5600,800,10.5000,10.5200,2501,500
GNRSW,3000,100,1.6500,100,1.5800,1.6300,3000,0
NSPR+,3000,200,0.0994,200,0.0506,0.0644,3000,0
BBAR,2994,1200,2.9300,29500,2.8600,2.8900,2894,100
OEUR,2989,300,25.3400,400,25.2800,25.2800,2989,0
CCD,2982,200,29.7700,100,29.5900,29.7500,854,2128
CWCO,2981,100,12.6400,100,12.5500,12.6100,2981,0
OSS,2979,100,4.1100,100,4.0500,4.0500,2979,0
BSCL,2973,5500,21.1800,3400,21.1700,21.1750,2933,40
CFIIW,2967,100,2.5600,100,2.4400,2.5500,2967,0
STPK+,2967,100,12.9300,100,12.6000,12.8000,1639,1328
AAON,2966,100,71.8200,4,71.6600,71.6200,2966,0
QIWI,2964,100,10.4300,100,10.4000,10.4100,2964,0
MSGE,2963,100,99.9100,100,99.1700,99.7950,2933,30
SNPE,2961,200,33.7600,100,33.7500,33.7400,2961,0
IDA,2956,100,89.1800,89,88.8600,88.9100,2672,284
Y,2955,10,592.7000,9,591.8700,592.2200,2953,2
VONE,2954,100,180.7600,200,180.7200,180.6900,2954,0
NRO,2953,250,4.1300,500,4.0900,4.0900,1363,1590
SRCL,2944,35,69.0000,100,68.8500,68.9900,2943,1
WDFC,2944,100,284.7400,6,282.8700,283.2300,2910,34
VYGG=,2943,100,11.5400,100,11.3100,11.2900,2600,343
QQQE,2940,100,77.9500,100,77.9300,77.8000,2931,9
PHCF,2939,100,3.1900,300,3.1000,3.1000,2939,0
NPO,2935,100,82.2600,100,81.5400,81.9600,2698,237
TREC,2929,100,7.1000,500,6.9900,7.0700,2929,0
BKEP,2928,200,2.0300,100,2.0000,2.0100,2928,0
YTEN,2923,100,12.7700,100,12.5500,12.7200,2723,200
QCRH,2921,100,39.7800,353,39.5700,39.6100,2921,0
FLY,2920,100,9.8600,100,9.8200,9.8300,2820,100
TTC,2920,100,100.9000,100,100.3100,100.5000,2877,43
FCN,2918,24,116.3200,2,115.9500,115.9700,2918,0
AVDL,2917,300,6.6800,2000,6.6200,6.6600,2917,0
EFT,2907,100,13.9300,100,13.8200,13.8800,2406,501
WTS,2906,100,127.5900,10,127.3400,127.5900,2874,32
FTA,2903,800,57.7500,500,57.7300,57.6400,2903,0
SBI,2902,500,9.2200,100,9.1700,9.2050,831,2071
CANE,2900,100,7.0100,100,6.9700,6.9800,2900,0
DFNS+,2900,300,1.8000,100,1.7200,1.7800,2900,0
AVO,2893,100,16.4400,82,16.3000,16.3300,2128,765
HAIL,2889,100,65.8600,300,65.7200,65.7900,2889,0
RSI+,2888,100,12.0800,100,11.6300,11.4000,2022,866
TPCO,2887,100,15.3400,100,15.1700,15.2800,2887,0
WMK,2880,1,47.2100,100,46.9700,47.0900,2816,64
SNP,2870,100,53.2600,100,53.1400,53.2500,2804,66
CCRN,2868,100,9.3400,100,9.2700,9.3400,2867,1
LNN,2868,100,149.3700,12,148.4500,148.7300,2868,0
SCHA,2868,500,96.5500,400,96.4600,96.5400,2868,0
XES,2866,600,50.0500,1100,49.9300,49.8800,2469,397
CELC,2862,15,14.6200,100,14.3400,14.5950,2767,95
CALF,2858,900,35.0500,700,35.0000,35.0200,2858,0
OXY+,2851,100,9.3500,100,9.2600,9.3400,2237,614
GIB,2844,100,80.1500,100,80.0900,80.1100,2516,328
GHL,2843,100,12.5900,100,12.5100,12.5100,2718,125
ENFAU,2841,300,10.4100,110,10.3700,10.3800,2841,0
FBND,2832,1000,53.8800,200,53.8400,53.8700,1832,1000
OFIX,2832,200,43.7500,100,43.6300,43.7400,2667,165
CPA,2825,100,79.3600,100,78.7000,79.0100,2584,241
JAN,2824,100,5.7700,100,5.6800,5.7200,2424,400
XENE,2824,100,16.7100,100,16.4600,16.4700,2437,387
PCPC=,2822,100,26.2500,100,25.8000,26.0000,2822,0
HOV,2819,100,39.3300,200,39.0000,39.1000,2668,151
MANH,2815,100,118.0800,6,117.8700,117.9900,2806,9
KURE,2813,600,43.3300,300,42.9800,43.0000,686,2127
ATR,2804,2,138.8000,100,138.7000,138.7400,2803,1
UMAY,2800,5400,27.5300,1200,27.3500,27.3500,2800,0
PLSE,2791,100,29.1100,40,28.6600,28.8900,2691,100
USB-H,2791,2200,24.2400,100,24.0700,24.2400,2791,0
CORP,2786,200,115.7500,100,115.6600,115.7350,2786,0
OMP,2783,100,14.6900,100,14.4600,14.6400,2583,200
DMYD+,2779,100,5.5000,100,5.4500,5.5000,2379,400
GGT,2779,100,8.2900,400,8.2800,8.2800,2278,501
MBWM,2779,100,28.9500,12,28.5600,28.7500,2718,61
FXC,2777,2800,77.9000,2800,77.8800,77.8600,2777,0
IYF,2777,1100,68.2900,1100,68.2600,68.3000,2777,0
MCB,2776,21,38.4900,100,37.9300,38.2200,2768,8
FULTP,2769,100,26.4500,100,26.1900,26.3000,2769,0
USNA,2763,100,85.3700,100,84.9100,85.2900,2762,1
RTP+,2762,100,3.6900,100,3.6300,3.6800,1658,1104
DSAC,2758,100,10.3100,100,10.2300,10.2700,2758,0
CHB,2757,800,17.9900,300,17.8800,17.9600,2757,0
WEBL,2751,10,74.5300,11,74.4000,74.4200,2641,110
BTO,2750,100,32.4500,100,32.0700,32.2100,2345,405
QUMU,2742,100,8.7800,100,8.6600,8.6000,2742,0
OILK,2739,300,47.0100,1100,46.9800,47.0000,2739,0
RYLD,2732,15,23.0100,1,22.9500,22.9600,2728,4
IGHG,2731,100,75.8300,100,75.7800,75.7800,2731,0
SLYG,2729,100,83.4600,747,83.3800,83.4200,2682,47
OXM,2721,17,71.6100,100,71.0200,71.3000,2711,10
FFSG,2715,300,32.7400,300,32.6000,32.6300,2715,0
RFI,2712,70,13.3900,100,13.2900,13.3600,1802,910
MEAR,2709,100,50.2300,300,50.1900,50.2100,1909,800
CCLP,2706,100,1.2100,100,1.1200,1.1800,2706,0
MSGS,2706,1,175.4100,140,175.1000,175.3200,2668,38
OPOF,2705,100,21.0400,100,19.6800,21.0100,2705,0
SYNC,2705,100,1.6900,300,1.6500,1.6800,2705,0
DFNV,2702,4000,27.3500,200,27.2700,27.2500,2702,0
FEP,2701,100,39.8300,500,39.6700,39.7700,2701,0
PRFX,2701,600,4.6000,100,4.4500,4.5300,2701,0
ALTY,2700,100,12.0600,100,12.0100,12.0300,2700,0
DBDRW,2700,100,1.6700,100,1.5400,1.6000,2700,0
HEZU,2700,1300,32.1100,1400,32.1000,32.1100,2700,0
BRG,2695,1000,11.5300,100,11.4100,11.4600,2695,0
MSEX,2693,54,73.1900,100,73.0500,73.2100,2685,8
CNCE,2692,200,10.6400,100,10.5800,10.5900,2692,0
AMTI,2685,100,36.9600,100,36.1800,36.4100,2665,20
ASIX,2676,100,22.3400,100,22.1600,22.2400,2676,0
EGP,2671,100,139.0700,100,138.1200,138.4700,2611,60
GSBD,2671,100,18.4600,300,18.2700,18.3700,2671,0
NGMS,2668,100,30.1200,100,29.6900,30.0000,2517,151
ASR,2662,261,162.3400,7,161.5000,162.6900,2662,0
PPGHU,2659,30,10.6300,100,10.5600,10.6100,2640,19
GSBC,2656,100,51.1100,9,50.0600,50.3400,2636,20
KB,2654,200,40.9000,100,40.7600,40.7800,2528,126
ARBG,2650,100,10.4100,100,10.2800,10.2600,2650,0
MGEE,2650,176,66.0500,100,65.6400,65.9500,2641,9
IBHA,2646,455,24.3300,20,24.3000,24.3200,2646,0
KJAN,2644,1400,29.7800,1000,29.6700,29.7500,2644,0
IHF,2640,100,249.3500,100,249.2200,249.3700,2640,0
WBK,2637,100,16.8700,100,16.7800,16.8600,2444,193
KOP,2633,1,35.5900,99,35.5300,35.5100,2633,0
FTHY,2630,100,19.4100,100,19.3100,19.4050,1930,700
CEFS,2620,100,20.5100,100,20.3200,20.3800,2455,165
CYTH,2619,100,6.1800,100,6.0100,6.1600,2119,500
NINE,2615,100,2.8200,700,2.7400,2.8000,2615,0
RYF,2613,800,50.4500,600,50.4200,50.5000,2613,0
CRNX,2612,200,15.1700,100,15.0600,15.1700,2612,0
MAIN,2608,200,32.8900,100,32.8200,32.8400,2564,44
ZKIN,2606,100,3.1500,100,3.0700,3.1100,2606,0
GLAD,2603,100,9.4400,5,9.4100,9.4200,2374,229
ROT=,2600,100,10.5900,200,10.4800,10.5300,2600,0
NGVC,2594,100,15.2500,100,15.1200,15.2100,2594,0
CHCO,2593,100,71.2000,100,70.6800,71.1900,2592,1
XJH,2590,8000,33.9200,7700,33.8700,33.9250,1116,1474
DEH,2584,100,10.3700,100,10.2800,10.3500,2584,0
ALTA,2581,100,32.6100,100,32.2100,32.4000,2579,2
UYG,2579,700,44.0700,600,44.0400,44.0500,2396,183
UNF,2577,100,223.1800,100,221.5800,222.0500,2561,16
ASG,2576,100,9.1600,100,9.0500,9.1200,2569,7
SIZE,2576,200,115.1500,2410,115.1100,115.1300,2476,100
BMA,2575,100,13.7800,100,13.6500,13.7000,2564,11
MOFG,2575,6,26.5900,100,26.3600,26.4900,2575,0
UEVM,2574,800,48.8500,800,48.6200,48.4900,2574,0
CMF,2570,300,62.8700,200,62.8400,62.8500,2370,200
DWFI,2570,48,26.3500,500,26.3200,26.3500,2474,96
SCVL,2568,100,42.0400,48,41.7000,41.8700,2475,93
BRPA,2557,100,44.1700,100,42.8400,43.1500,1976,581
PFSW,2557,200,7.6500,100,7.5300,7.5600,2557,0
HTBI,2555,370,20.2400,200,20.0600,20.2000,2555,0
ABCM,2554,100,23.8400,100,23.4800,23.6400,2479,75
IMAB,2552,100,53.7600,100,53.2400,53.4900,2552,0
NES,2552,100,2.7900,100,2.7100,2.7800,952,1600
MFMS,2551,800,41.4200,100,41.1300,41.3500,2551,0
DLCAU,2550,100,10.8900,200,10.8100,10.8200,2050,500
DOOO,2550,1,71.0100,100,70.9300,71.1400,2350,200
LCY,2544,200,10.4900,123,10.4000,10.4700,2544,0
SALM,2543,800,1.7800,100,1.7400,1.7700,2543,0
TNK,2542,100,11.2000,100,11.1100,11.1100,2542,0
THCBW,2537,100,4.0400,100,3.9400,3.9800,2457,80
NSCO,2532,100,7.5600,100,7.4900,7.5400,2436,96
MTD,2531,4,1247.8500,4,1245.0100,1248.6200,2484,47
FINX,2530,400,47.8100,700,47.6900,47.6900,2530,0
MOGU,2525,1155,2.5000,100,2.4300,2.4000,2525,0
SOJE,2520,100,25.3000,100,25.1200,25.2100,2420,100
CACI,2517,11,248.3500,100,246.9200,248.1600,2425,92
CREG,2517,100,6.3300,100,6.2100,6.2400,2497,20
CCRC,2514,3,4.0400,100,4.0100,4.0300,2414,100
PIXY,2514,300,3.0400,200,3.0100,3.0200,2514,0
PSMT,2511,1,97.2600,23,96.7000,96.8900,2511,0
SBNYP,2510,100,25.5000,100,25.3700,25.4700,2510,0
EXFO,2507,100,3.7100,100,3.6300,3.6400,1507,1000
CTS,2504,100,34.9800,100,34.8600,34.8700,2403,101
SIGIP,2503,100,25.0000,100,24.8800,25.0500,2503,0
TSLX,2503,100,21.1300,500,21.0200,21.1000,2503,0
SGAM,2502,100,10.3300,9000,10.2500,10.2500,2300,202
FYC,2501,100,69.6300,200,69.5300,69.6400,2401,100
MATW,2501,100,31.6300,100,31.3700,31.4800,2500,1
BREZR,2500,700,0.3401,100,0.3000,0.3302,2500,0
YTRA,2500,200,2.1900,200,2.1700,2.1700,2500,0
PFBC,2498,100,50.2100,100,49.6300,49.9700,2498,0
IMRA,2495,100,14.0600,100,13.9600,13.9700,2194,301
IBDO,2490,5600,26.2500,200,26.2400,26.2450,2390,100
IFFT,2490,100,43.0700,200,43.0400,43.0700,1000,1490
MANU,2490,100,15.9800,100,15.8100,15.8500,2187,303
VCAR,2486,2500,14.9100,2500,14.7600,14.9100,2486,0
ASPU,2484,200,10.0100,100,9.8500,9.9200,2484,0
ERIE,2484,11,241.7400,28,240.7000,241.3600,2444,40
TATT,2483,100,6.2500,100,6.1000,6.1000,1338,1145
DIAL,2481,8026,21.8900,100,21.8700,21.8800,1799,682
AACQW,2475,100,2.5700,100,2.4800,2.5100,2200,275
FEDU,2471,500,1.2100,200,1.1300,1.1900,2471,0
TYHT,2470,300,3.7000,200,3.6300,3.6300,2170,300
AOM,2467,100,43.7900,100,43.7400,43.7800,2367,100
TFX,2467,100,390.4500,100,389.7100,390.0400,2357,110
TMP,2466,100,75.0400,105,74.4200,74.5200,2466,0
CNS,2461,100,73.9800,60,73.7400,73.8400,2456,5
HYT,2458,100,11.3200,400,11.2700,11.2800,2431,27
FEX,2454,100,77.0400,600,77.0100,77.0300,2454,0
SMMV,2453,100,35.4200,100,35.3900,35.4400,2453,0
HOFVW,2450,200,0.6700,100,0.5400,0.5720,2100,350
OSMT,2449,2500,4.3300,2400,4.2600,4.3200,2349,100
ANIK,2443,11,39.8600,100,39.3300,39.5800,2443,0
UIHC,2439,100,5.7100,600,5.6300,5.6700,2439,0
ESGG,2437,300,128.9600,400,128.4900,127.9100,2437,0
KRYS,2437,100,70.0600,24,69.7900,69.9300,2436,1
FEN,2435,100,12.1400,300,12.0300,12.0500,2335,100
SCHG,2433,200,132.4000,100,132.3700,132.3700,2433,0
SNEX,2433,100,57.2700,6,57.0200,57.0900,2433,0
EGRX,2432,9,48.5900,100,48.1100,48.4800,2432,0
NIE,2430,250,29.1700,132,29.1400,29.1900,2049,381
CDR,2429,100,11.4600,100,11.2600,11.2100,2429,0
ANVS,2428,100,10.2500,20,10.2000,10.0200,2228,200
IACA,2423,200,12.5500,100,12.4100,12.5100,2423,0
DNK,2416,100,2.9400,87,2.8700,2.8800,2416,0
AMK,2414,100,24.9300,190,24.8400,24.9100,2414,0
JRI,2412,1000,13.6200,100,13.5300,13.5700,1012,1400
MG,2412,100,8.3100,100,8.2100,8.2500,2028,384
CIR,2406,100,36.9600,100,36.6100,36.8500,2406,0
NBA=,2405,100,11.4400,900,11.2700,11.3100,2405,0
EXI,2402,1,108.6800,100,108.1100,108.3000,2402,0
AEACU,2400,100,10.5300,44,10.4400,10.4750,2200,200
FTIVU,2400,600,12.7500,900,12.6600,12.7000,2400,0
GOAC=,2400,400,11.0100,900,10.9600,11.0000,2400,0
HTPA=,2400,100,11.0100,100,10.8700,10.9100,1300,1100
KROS,2400,177,64.8900,100,64.2800,64.7800,1743,657
OCA,2400,200,10.3000,100,10.2200,10.2900,2100,300
SVSVW,2400,100,2.0200,100,1.9300,1.9900,2400,0
NSP,2398,137,84.1200,100,83.3300,84.0400,2367,31
FCRD,2389,200,3.7000,100,3.5800,3.5800,2389,0
FDD,2389,400,13.3400,1200,13.3000,13.2950,2389,0
HZAC,2387,100,10.6900,100,10.6700,10.6700,2387,0
ICLR,2382,9,218.5400,9,218.0100,218.3350,2282,100
JRVR,2382,100,48.2100,20,47.8800,48.1400,2370,12
ALRS,2373,100,27.9600,133,27.6000,27.6300,2373,0
VRIG,2370,400,25.0700,400,25.0600,25.0600,1170,1200
ASC,2369,100,3.3800,800,3.3400,3.3600,2369,0
KLXE,2365,100,8.4800,100,8.3700,8.4500,2067,298
JCPB,2363,300,55.4500,303,55.2900,55.3000,2363,0
CNP-B,2360,200,40.8000,200,40.6000,40.6300,2360,0
LGVW+,2359,100,7.1500,100,7.0100,7.0900,1769,590
KSPN,2358,100,42.4100,100,39.3200,41.7000,1955,403
CVGW,2355,300,73.3000,100,72.7800,73.2900,2355,0
DUK-A,2354,100,28.2000,100,28.0100,28.2100,2154,200
OPRT,2352,100,17.2200,100,16.7600,16.9700,2352,0
OCSI,2351,200,7.9100,200,7.8700,7.8900,2351,0
ASPS,2348,100,11.2900,100,11.1700,11.2200,2348,0
KNG,2345,1000,48.2900,24,48.2700,48.2900,2345,0
AVUS,2343,2500,66.0700,2500,66.0100,66.0800,2343,0
FCVT,2340,500,52.7300,500,52.3700,52.7100,2040,300
LUNG,2340,100,63.3500,3,62.3200,62.8900,2185,155
NBHC,2339,26,35.5300,1,35.4300,35.4600,2338,1
HCCI,2332,74,22.6500,100,22.4000,22.6400,2319,13
ORMP,2331,200,4.5600,1000,4.5100,4.5700,2331,0
TPYP,2326,700,18.5800,200,18.5400,18.5200,1201,1125
SASR,2325,100,35.0000,300,34.6200,34.8100,2324,1
TARS,2324,100,41.8600,100,41.1100,41.6800,2213,111
VGAC+,2321,100,3.5800,100,3.4700,3.5000,1698,623
DRIO,2320,100,21.4500,100,20.8600,21.3450,2140,180
NWHM,2320,200,5.6200,100,5.4300,5.5750,1920,400
SGOC,2318,100,1.7100,100,1.6800,1.7000,2318,0
FYT,2317,441,44.8400,100,44.7900,44.8300,2317,0
GREK,2314,200,25.2800,300,25.0300,25.2300,1605,709
IPFF,2314,72,16.0000,93,15.9700,15.9600,886,1428
LUMO,2314,100,19.1900,100,18.8900,18.9300,2274,40
LANC,2309,20,175.1500,110,174.8900,175.0500,2254,55
USRT,2308,400,48.7600,100,48.7500,48.7600,2108,200
INDY,2306,300,44.5300,300,44.2900,44.3000,599,1707
FDEV,2305,700,28.0500,100,27.9400,28.0000,2305,0
FIDU,2301,400,48.1700,1000,48.1400,48.1600,2301,0
CAP=,2300,100,10.6900,100,10.5800,10.6500,2300,0
DFAE,2300,100,29.1200,38,28.9100,29.0000,2300,0
GXGXW,2300,100,1.5900,100,1.5400,1.5800,2300,0
NRC,2300,101,47.7000,100,47.0200,47.4400,2300,0
THCAW,2300,100,2.3800,100,2.2300,2.3500,2300,0
SPNV=,2297,308,12.1200,900,12.0700,12.0600,2297,0
PSI,2294,100,120.6000,100,120.4500,120.4700,1159,1135
HAYN,2292,200,24.1700,100,24.0300,24.1600,2201,91
IEP,2292,100,56.4900,100,56.0500,56.1500,2292,0
NMRD,2291,400,4.9900,100,4.8400,4.8900,2291,0
HEES,2290,12,31.5400,14,31.4000,31.4700,2252,38
WFC-Z,2290,100,25.6800,800,25.5400,25.6500,2290,0
BMEZ,2289,100,30.3800,60,30.2400,30.3400,2289,0
SOJD,2289,100,26.5600,100,26.2900,26.4900,2163,126
BUFF,2288,300,33.3900,500,33.3300,33.4100,2288,0
BFIIW,2281,100,2.1600,100,2.0600,2.1200,2281,0
KAMN,2271,200,55.7300,100,55.3000,55.5000,2270,1
KRP,2269,100,9.0300,100,8.9400,8.9800,2259,10
OSBC,2268,200,10.5700,200,10.4300,10.4900,2268,0
CHT,2264,464,38.8200,100,38.7900,38.8000,2232,32
FDVV,2264,400,33.2600,500,33.2100,33.2400,1164,1100
TINV=,2264,100,11.5000,500,11.3400,11.4700,2064,200
CPLP,2262,100,9.8500,100,9.8000,9.7900,2262,0
ELOX,2260,100,4.0600,160,3.9700,4.0200,2260,0
IVAC,2257,200,7.1500,100,7.1100,7.1300,2257,0
GCV,2255,535,6.5200,100,6.4600,6.5000,1352,903
TKC,2254,900,5.5300,400,5.5200,5.5300,2154,100
ARBGU,2253,100,10.9200,100,10.7600,10.8000,1228,1025
PEO,2252,100,12.7700,25,12.6400,12.6700,1246,1006
NOVT,2249,100,133.9600,10,132.8500,133.0800,2249,0
LATN,2246,400,10.4200,100,10.3900,10.3900,2246,0
LEAP,2241,100,14.9800,700,14.8000,14.8000,2241,0
NOACU,2240,200,11.3900,300,11.3000,11.3800,2140,100
IBDP,2239,6100,26.5900,400,26.5700,26.5800,2039,200
FXH,2235,200,112.2100,200,112.1500,112.3600,2235,0
AGFS,2232,400,2.0400,100,2.0100,2.0250,2135,97
FDIS,2230,400,76.4800,400,76.4400,76.4400,1604,626
MDJH,2230,800,4.5900,100,4.3300,4.5000,2230,0
DAVA,2223,100,80.9700,100,79.9800,80.6700,2223,0
ASPL,2210,200,10.2500,100,10.1600,10.2000,1100,1110
RWO,2210,400,44.4300,400,44.2500,44.4300,2204,6
SBE+,2208,100,17.6200,100,17.4900,17.5800,1808,400
LAND,2207,800,16.4200,200,16.3000,16.3400,2207,0
SLYV,2207,300,72.1200,75,72.0800,72.0800,2207,0
XVV,2207,1100,29.4200,1003,29.3900,29.3900,2207,0
NSH,2206,100,10.5500,100,10.4300,10.5000,2206,0
NBA,2205,100,10.3300,100,10.2300,10.2100,2205,0
DBE,2200,600,11.6100,100,11.6000,11.6100,700,1500
JPHY,2200,1300,52.0000,400,51.9700,52.0000,1900,300
WTBA,2200,100,20.9500,100,20.6600,20.8700,2200,0
PDT,2199,200,13.9000,100,13.8300,13.8900,1405,794
BDEC,2198,300,31.0300,40,30.9500,30.8900,2198,0
GLL,2196,900,32.0300,900,32.0100,32.0300,2196,0
BJK,2195,100,48.1900,100,47.7100,47.8600,1895,300
FLQL,2195,2400,38.6400,6810,38.6100,38.6300,2195,0
OUNZ,2192,18600,18.2100,22300,18.2000,18.1650,2192,0
PLXP,2192,100,5.9300,200,5.6500,6.0500,2192,0
LND,2187,100,5.2200,100,5.0700,5.0600,2187,0
NGS,2182,100,9.1500,100,9.0200,9.0000,2182,0
PRF,2182,500,139.5400,200,139.5000,139.5800,1412,770
VOC,2172,100,2.8300,100,2.7300,2.7500,2123,49
NMCO,2168,100,13.6800,200,13.6600,13.6600,2158,10
MMI,2166,21,39.0000,106,38.8800,38.9450,2065,101
OLMA,2165,200,41.9900,100,41.5100,41.7500,2018,147
WRLD,2165,100,118.0800,100,116.2300,116.7600,2164,1
IWX,2162,200,59.5400,3280,59.5100,59.4200,2162,0
HAUZ,2159,600,26.7700,300,26.5400,26.6100,2159,0
PDAC=,2158,500,13.7100,900,13.6200,13.6700,2158,0
VPG,2157,100,33.8400,100,33.4000,33.7200,2157,0
CRF,2148,100,12.0200,100,11.9900,12.0000,1940,208
WSO,2148,100,247.7800,100,245.5900,246.2500,2145,3
APYX,2145,100,10.5900,100,10.5100,10.5900,2145,0
AKER,2143,100,2.7400,300,2.7000,2.7100,2143,0
FGNA+,2143,100,2.0700,100,1.9900,2.0500,1800,343
VGT,2143,300,364.8200,300,364.6900,364.4700,2143,0
IO,2141,100,2.9400,100,2.9000,2.9200,2141,0
HYS,2140,100,98.4800,200,98.4400,98.4800,2139,1
SAM,2137,1,920.2200,100,914.6600,918.9500,1765,372
SVACW,2137,100,2.2100,100,2.1200,2.1500,1747,390
VOX,2131,300,123.7500,400,123.6900,123.8000,1431,700
OPY,2128,100,32.8300,100,32.5600,32.7100,2128,0
AFT,2127,100,14.6800,100,14.5600,14.6300,1227,900
NEWT,2126,100,20.9300,100,20.6700,20.8200,2126,0
THW,2125,500,17.4000,400,17.3100,17.3700,2021,104
GTYH,2122,100,6.5700,100,6.4600,6.5300,2122,0
EVA,2121,100,48.5200,200,47.8100,48.2500,2001,120
IYH,2117,100,257.1000,100,257.0300,256.7400,2117,0
DZSI,2115,100,16.8700,100,16.5900,16.7300,2115,0
ADUS,2112,3,124.5500,100,123.8900,124.1600,1909,203
LBC,2112,100,10.2500,82,10.1700,10.2100,2112,0
DFAI,2110,1000,27.4300,100,27.3700,27.4200,2110,0
HIO,2110,1500,4.9200,800,4.9100,4.9200,1906,204
PFLT,2108,1,11.1900,90,11.1700,11.2700,2108,0
CLPR,2107,100,7.2800,100,7.2000,7.2300,2107,0
AMZA,2103,100,21.1600,1100,21.0300,21.1000,2103,0
AMTBB,2100,100,12.5300,100,12.2100,12.1000,2000,100
GL-C,2100,100,25.8400,100,25.5700,25.6800,2100,0
HDEF,2100,1400,23.9900,400,23.9400,23.8600,2100,0
IEHS,2100,400,38.9100,410,38.8800,38.9100,2100,0
FNHC,2098,100,5.6700,100,5.6100,5.6500,2098,0
VIS,2093,300,174.3400,300,174.2300,174.4000,2093,0
NGL-C,2091,100,13.9100,100,13.6300,13.7600,1271,820
GLO,2086,100,12.1400,500,12.0800,12.1200,2035,51
IHG,2086,100,66.8200,100,66.2800,66.4000,2086,0
ATNI,2083,100,46.1600,100,45.2900,45.7700,2083,0
GAIN,2083,100,10.9400,1,10.8700,10.9100,2082,1
BCI,2081,100,22.5500,10,22.3500,22.4500,2081,0
FTGC,2076,100,19.9700,200,19.8800,19.9500,2076,0
FXB,2071,1100,132.6600,1000,132.6300,132.5500,2071,0
INAQW,2065,100,4.5700,100,4.4500,4.5400,2065,0
PCTY,2064,10,200.6900,100,199.9200,200.0900,2063,1
NTG,2061,100,24.1900,334,24.0000,24.0100,696,1365
PBT,2060,400,3.4600,400,3.4100,3.4300,2060,0
PTMN,2057,300,1.9200,200,1.8900,1.9300,2057,0
VIGI,2056,1400,84.0300,400,83.7900,83.9100,2056,0
FRGI,2055,100,15.4400,100,15.1600,15.3850,2055,0
KBWP,2054,500,69.4800,500,69.3800,69.6700,2054,0
VRTV,2053,100,22.9000,100,22.4900,22.6000,2003,50
QQQX,2052,100,26.7800,200,26.5800,26.5700,1142,910
SGDM,2052,39,29.6900,39,29.6200,29.6800,719,1333
JYNT,2049,100,29.8600,100,29.4800,29.5000,2049,0
SCD,2048,100,12.0200,500,11.9100,11.9700,945,1103
JHSC,2040,700,32.7300,100,32.7000,32.7200,2040,0
MDGL,2040,1,109.5800,7,108.5100,108.9400,1923,117
FFG,2039,100,56.7000,300,56.0900,56.3700,1934,105
BNGOW,2038,100,6.1200,100,6.0000,6.0600,2038,0
SCPH,2035,100,6.6200,320,6.5300,6.5500,2035,0
SPKE,2034,200,11.0900,100,10.9700,11.0000,2034,0
FDUS,2032,100,13.7800,500,13.7300,13.7500,2032,0
XOMA,2031,100,39.1300,100,38.1500,39.0000,2001,30
FPL,2030,100,4.8000,100,4.7400,4.7800,2030,0
FDEM,2026,105,28.6300,5,28.4000,28.4100,2026,0
CHUY,2025,100,34.2700,100,33.9500,34.0000,2025,0
SAFT,2023,100,78.2500,1,77.5000,77.8000,2013,10
GNE,2022,100,7.6800,300,7.6400,7.6500,2022,0
IXJ,2021,8,79.1400,400,78.9800,79.1300,1073,948
LFVN,2015,100,9.3300,100,9.2600,9.2800,1931,84
BKAG,2011,332,50.3200,309,50.2900,50.3300,2011,0
RDIV,2011,7780,35.7100,600,35.6900,35.7000,1381,630
UTI,2010,100,6.3000,400,6.2200,6.2800,2010,0
EUM,2005,10868,11.7900,200,11.7800,11.7900,2005,0
MAAX,2001,300,25.1200,399,25.0600,25.0600,2001,0
CAS=,2000,100,10.9800,900,10.8800,10.9000,2000,0
MDWD,1998,500,5.2100,100,5.0700,5.1700,1998,0
PCYG,1998,100,5.4600,100,5.3900,5.4500,1998,0
BMAR,1995,450,29.9000,300,29.8100,29.9000,1995,0
CUTR,1993,100,26.1200,100,25.6400,25.8600,1993,0
RPG,1993,200,170.4500,400,170.3800,170.3400,1493,500
XL+,1993,100,7.6000,100,7.3400,7.5500,1893,100
EIDX,1991,100,122.6900,100,122.0100,122.4100,1990,1
UI,1986,38,261.5400,100,259.7200,259.2300,1886,100
PCF,1981,200,8.5800,100,8.5500,8.5900,1087,894
FLCO,1978,500,26.7500,46,26.7400,26.7500,1656,322
IBDN,1977,5300,25.5500,600,25.5400,25.5450,1977,0
AMSF,1976,100,56.3500,90,56.1700,56.1700,1975,1
APPF,1976,100,156.9700,39,156.5900,157.0600,1950,26
ATXI,1975,100,6.3100,200,6.2500,6.2100,1975,0
JFR,1973,100,9.3200,100,9.2400,9.2750,1973,0
ABTX,1971,100,36.2300,100,35.9600,36.0300,1971,0
HRMY,1969,100,36.6200,100,36.1100,36.5600,1969,0
MED,1969,23,221.8500,100,220.1900,221.8200,1968,1
UTG,1969,100,33.1700,100,32.8800,32.9000,1056,913
HLAL,1967,300,35.4600,400,35.4200,35.3800,1967,0
CPLG,1966,200,7.1200,13,7.0400,7.0900,1777,189
BFST,1965,33,21.1600,33,20.9500,21.1400,1965,0
NYMX,1962,100,2.4700,500,2.4100,2.4400,1962,0
BGR,1959,200,7.8500,100,7.7400,7.7800,699,1260
FUNL,1958,500,29.5900,500,29.5600,29.5750,1958,0
CHCT,1955,100,48.6500,100,48.2900,48.6300,1923,32
VBK,1955,200,287.5200,100,287.3600,287.5000,1955,0
BF.A,1949,204,67.8600,10,67.6000,67.6500,1796,153
BWAY,1944,100,10.4000,100,10.2200,10.2500,1604,340
CCAP,1944,100,15.7300,100,15.5000,15.5100,1944,0
FSTX,1944,100,9.2500,100,9.1200,9.2900,1755,189
JHEM,1942,100,31.6600,2600,31.6100,31.6500,1942,0
BOMN,1941,100,26.3900,100,26.2100,26.2300,1941,0
IH,1937,100,20.7800,100,20.1300,20.5900,1768,169
GRC,1932,100,33.2400,200,32.9100,32.9800,1682,250
PLOW,1932,100,43.5900,300,43.0800,43.3900,1930,2
USPH,1932,100,127.9500,100,126.7000,127.4200,1922,10
FPAY,1928,100,3.2700,1900,3.1600,3.2000,1928,0
RBAC+,1928,100,2.2100,100,2.1400,2.2000,1411,517
RING,1927,100,30.0600,500,29.8800,30.0000,1927,0
BUG,1926,800,28.8300,400,28.6600,28.7200,1326,600
ITOS,1923,100,34.7500,100,34.0900,34.5200,1923,0
BLIN,1922,2,3.3100,100,3.2500,3.2900,1854,68
WASH,1919,100,46.5200,100,46.0100,46.3000,1919,0
BUFR,1918,2900,21.7400,200,21.6200,21.6300,1918,0
FVE,1918,100,7.2000,800,7.1200,7.1700,1918,0
MEN,1918,100,12.1800,100,12.0500,12.1500,1415,503
HIMS+,1912,200,5.3300,200,2.9200,4.2000,925,987
FSR+,1906,100,5.1300,100,5.0700,5.1700,1706,200
MYO,1905,100,10.9100,100,10.7600,10.8100,1841,64
SHAG,1905,4300,51.4100,200,51.3700,51.4100,1905,0
AMNB,1902,100,28.1500,100,27.8600,27.9900,1902,0
HTY,1901,500,5.7800,1,5.7600,5.7700,600,1301
MRACU,1901,100,11.0100,100,10.8800,10.9500,1801,100
TPIF,1901,300,28.0700,100,27.9500,28.0100,1701,200
AVAN=,1900,300,12.1000,26,12.0600,12.1200,1900,0
DUO,1900,100,8.7700,100,8.6200,8.6100,1500,400
HECCU,1900,400,12.8700,860,12.7700,12.9200,1900,0
IBMK,1900,800,26.4100,248,26.3500,26.4100,1900,0
IIAC,1900,200,10.7400,300,10.7000,10.6500,1900,0
PBTP,1900,7900,26.0700,18075,26.0500,26.0500,1900,0
UMH-D,1900,100,24.8800,100,24.7000,24.8000,1900,0
BTAQU,1899,500,13.0900,900,13.0200,13.0100,1899,0
ENLV,1896,100,11.8000,100,11.4800,11.6900,796,1100
FRHC,1896,100,53.2800,200,52.7400,53.0100,1296,600
AGM,1895,100,79.9300,40,79.3000,79.4800,1839,56
TH,1893,1100,1.5700,5677,1.5500,1.5600,1893,0
SPRB,1892,100,21.1300,100,20.8100,20.9100,1792,100
CMCL,1890,200,15.5100,100,15.2200,15.4100,1890,0
IOSP,1889,89,95.9300,100,95.4100,95.6100,1879,10
FC,1888,100,24.5900,100,24.1900,24.4000,1888,0
DSM,1885,100,7.8500,100,7.7700,7.8100,1885,0
QQEW,1885,200,104.6800,200,104.6200,104.6400,1285,600
MCMJ,1884,100,10.4800,100,10.4300,10.4800,1884,0
CDXC,1883,300,4.8300,1400,4.7900,4.8200,1883,0
PACE+,1883,100,2.3000,100,2.2500,2.3000,1883,0
JRJC,1881,100,9.6800,100,9.5400,9.5500,1881,0
SCL,1880,100,120.8900,100,120.0000,120.7200,1879,1
CSV,1873,100,34.8700,100,34.5400,34.6800,1873,0
HHR,1873,100,29.7100,100,29.4700,29.5000,1752,121
RNP,1872,89,22.2000,100,22.0700,22.1900,1468,404
PRPB=,1869,400,11.2800,400,11.2400,11.2400,1869,0
SGU,1868,100,9.8700,100,9.7800,9.8100,1868,0
MTRN,1867,100,67.3100,100,66.5700,66.9900,1857,10
NVGS,1862,100,11.2300,100,11.0700,11.2000,971,891
KRO,1861,200,15.2600,100,15.1000,15.1900,1861,0
RLMD,1861,100,36.0800,100,35.4400,35.9400,1831,30
IFV,1859,600,23.6800,600,23.4600,23.5200,1859,0
CAS+,1856,100,1.5000,100,1.4600,1.5000,1856,0
WANT,1854,100,61.0700,13,60.9900,61.0600,1854,0
PRCHW,1852,200,5.7100,100,5.3300,5.7900,1852,0
HBT,1851,100,15.1700,100,15.0700,15.0700,1851,0
DYAI,1848,100,5.7000,1300,5.6200,5.6500,1848,0
GIGB,1846,400,55.4800,100,55.4700,55.4600,1246,600
BOOM,1841,9,48.4500,100,48.1600,48.3700,1841,0
OMFS,1839,500,36.7100,500,36.6000,36.5700,1839,0
AMTB,1835,97,14.4500,1400,14.2800,14.4500,1835,0
DGRW,1835,6170,54.8400,1300,54.8200,54.8500,1835,0
EMD,1834,100,13.6700,10,13.6500,13.6700,735,1099
AOA,1829,100,66.1600,100,66.1000,65.9700,1631,198
USFR,1825,61200,25.1100,68100,25.1000,25.1050,1745,80
CHAQ,1819,100,10.6000,100,10.4600,10.5350,1819,0
NBN,1818,35,26.7100,100,26.3800,26.6900,1818,0
LMAT,1815,100,45.3900,200,44.9600,45.1400,1815,0
MRAM,1815,800,5.9500,600,5.8700,5.9400,1815,0
CMCO,1813,100,43.3900,100,43.0000,43.1500,1778,35
DSPG,1813,100,16.9000,200,16.8300,16.9100,1812,1
USMC,1813,5660,36.1900,6070,36.1600,36.1700,1305,508
MAGA,1811,300,31.1800,400,31.1000,31.1600,1811,0
BAC-M,1810,100,27.1400,200,27.0900,27.1400,1063,747
ALL-H,1803,100,26.9600,100,26.7000,26.8400,1803,0
USDP,1803,100,4.6700,200,4.5500,4.6100,1803,0
ADES,1801,100,5.3900,1,5.3200,5.3800,1801,0
TTT,1801,1900,34.0200,1200,33.9600,34.0800,1801,0
BSMT,1800,100,26.1300,200,26.0300,26.1200,1700,100
CCAC=,1800,400,11.9500,900,11.6300,11.6700,1800,0
ENPC=,1800,200,26.6500,900,26.2000,26.4200,1800,0
LEJU,1800,200,2.6100,600,2.5600,2.5900,1800,0
FCT,1798,100,11.7700,100,11.6800,11.7400,1798,0
RDY,1798,100,69.1000,200,68.8400,68.8400,1773,25
REX,1798,16,87.8600,230,86.5200,86.6900,1664,134
SMBK,1795,100,20.3600,100,20.1200,20.2200,1695,100
MTL-,1788,2600,0.5390,2400,0.5200,0.5390,1788,0
PKE,1787,105,14.1900,100,14.1100,14.1500,1648,139
WPP,1787,100,54.5000,100,54.3400,54.4800,1787,0
NVG,1785,287,16.7400,100,16.7200,16.7400,1785,0
LUXA,1780,100,11.0400,100,10.9300,10.9500,1680,100
FMAC=,1778,302,11.8400,400,11.7200,11.7600,1778,0
PHAT,1776,100,38.9000,116,38.6100,38.7400,1776,0
RTP=,1776,400,14.8100,900,14.3900,14.6200,1776,0
WRN,1775,600,1.2500,200,1.2400,1.2450,1683,92
CNA,1772,100,40.7500,300,40.5500,40.7700,1659,113
RQI,1772,800,12.2700,100,12.2200,12.2200,1172,600
STIC=,1772,400,16.2100,200,16.1400,16.1700,1772,0
FFWM,1770,5,20.9400,100,20.8000,20.9000,1770,0
LCNB,1770,300,15.3900,26,15.3500,15.3000,1770,0
HTEC,1768,400,48.1800,400,47.9800,48.1300,1668,100
MIRM,1768,100,18.9400,100,18.6700,19.0800,1768,0
PRK,1767,100,112.8000,100,112.1900,112.2000,1737,30
ADRE,1766,100,62.6600,100,62.3400,62.2000,1766,0
AVCT,1765,100,8.8500,100,8.6600,8.8300,1765,0
CIGI,1763,100,94.4800,100,94.2400,94.1200,1663,100
AWAY,1762,1300,26.5000,300,26.4400,26.4700,1762,0
DSI,1762,150,73.5000,1810,73.4600,73.5000,1667,95
SRDX,1759,78,45.0100,100,44.6000,44.8100,1579,180
AGBAR,1755,9,0.4749,100,0.3820,0.4000,1755,0
GHM,1755,100,16.8000,100,16.6400,16.7700,1356,399
CECE,1754,200,7.7400,200,7.6900,7.7000,1754,0
STFC,1754,100,17.9200,100,17.6200,17.8200,1754,0
GSLC,1752,700,78.0000,300,77.9600,77.9600,1752,0
CYBE,1749,100,26.1700,100,25.8000,25.9200,1748,1
MNR-C,1740,100,25.1800,1160,25.0700,25.0700,1740,0
CEE,1739,200,24.9000,100,24.7200,24.8100,0,1739
IYC,1739,1600,72.2000,1800,72.1600,72.2300,1739,0
SYX,1737,100,39.0400,100,38.6600,38.8800,1737,0
PZN,1736,100,8.4200,100,8.3600,8.4000,1001,735
VVI,1735,100,37.1600,100,36.8500,36.9400,1734,1
BSMU,1733,60,25.6300,100,25.5600,25.6300,1733,0
RDVT,1726,100,22.8300,100,22.4100,22.6700,1726,0
BDR,1722,100,1.6800,200,1.6000,1.6000,1570,152
FLV,1722,1000,55.2600,1000,55.1700,55.2600,1722,0
TYG,1722,200,22.8900,300,22.7500,22.8000,1040,682
AIO,1720,100,28.7600,200,28.4500,28.5600,1720,0
USB-M,1720,100,26.6100,100,26.3900,26.5100,1720,0
NULG,1718,62,58.5800,3920,58.5400,58.5700,1718,0
VTOL,1713,100,27.6000,17,27.1600,27.3200,1712,1
RNET,1712,700,7.2100,100,7.1300,7.1400,1587,125
ECNS,1709,100,56.8000,100,56.2300,56.4700,1701,8
ROLL,1706,100,185.9700,2,184.7600,185.1000,1683,23
ESGR,1705,100,213.1700,100,210.6900,212.4300,1705,0
GDEN,1705,100,20.1100,100,19.9100,19.9600,1505,200
CLIR,1704,100,4.0000,4,3.9200,3.9500,1436,268
AINV,1702,100,12.3400,100,12.2800,12.3600,1702,0
SJIJ,1702,100,25.9700,400,25.7400,25.8300,1702,0
SCHB,1701,100,94.2500,300,94.2400,94.2100,1611,90
BIBL,1700,1600,37.6800,100,37.6300,37.5800,1700,0
FGB,1700,100,3.4200,202,3.3800,3.3800,1700,0
SRS,1700,1566,12.2500,1900,12.2300,12.2400,1700,0
STIC+,1700,100,4.0300,100,3.9500,3.9800,1600,100
TBC,1700,100,27.7700,100,27.4700,27.7500,1700,0
UHT,1691,100,66.3700,100,65.5700,65.9300,1691,0
AGGY,1689,400,53.2200,1239,53.2000,53.2200,1689,0
AOR,1689,1200,53.3900,1700,53.3500,53.3600,1249,440
ALG,1685,100,153.6400,11,152.6600,152.9300,1685,0
HELX,1683,1000,50.4100,1,50.3700,50.4900,1683,0
KLDO,1682,100,12.1200,124,12.0100,12.0300,1682,0
EBF,1668,100,18.6500,100,18.5200,18.5900,1576,92
AGE,1665,700,1.9500,700,1.8800,1.9000,1665,0
IIN,1661,100,19.9400,100,19.4200,19.4700,1421,240
PEBO,1661,100,31.2000,100,30.9900,30.9900,1661,0
GPACU,1660,40,10.5000,100,10.4300,10.4900,1660,0
MTBC,1660,10,10.5100,100,10.3900,10.4900,1660,0
LAZY,1657,100,19.7600,100,19.4300,19.5200,1466,191
PAND,1652,100,18.4800,100,17.9200,18.0300,1294,358
RADI,1651,100,12.9700,100,12.8700,12.8900,1651,0
RPAR,1650,10,24.1300,1,24.0700,24.1000,1643,7
VDC,1648,100,169.6100,200,169.5700,169.5700,1648,0
APSG+,1647,100,2.3500,100,2.2600,2.3400,1627,20
TISI,1646,7,11.1700,300,11.1200,11.1700,1548,98
IBHD,1639,244,24.4900,221,24.4400,24.4000,1639,0
TRND,1639,700,28.6900,200,28.6800,28.6600,1639,0
NSSC,1638,100,28.8600,100,28.7700,28.8250,1422,216
TY,1637,500,30.6400,200,30.5500,30.5700,1637,0
LRMR,1635,100,18.2300,100,17.7200,18.0700,1595,40
CIT-B,1634,100,26.4300,100,26.1600,26.3200,331,1303
EYPT,1634,100,9.8300,100,9.7500,9.8000,1422,212
HLIO,1632,100,57.3600,100,57.0500,57.2500,1632,0
TSHA,1632,300,30.8800,100,30.2500,30.7500,1624,8
OBNK,1629,31,30.1700,31,29.8500,30.0300,1629,0
NEE-P,1626,200,54.1800,200,54.0600,54.2800,1626,0
VGLT,1626,5800,92.0700,1700,92.0300,92.0600,1626,0
USAK,1625,100,11.6100,100,11.3600,11.5000,1625,0
ASA,1623,100,21.7800,100,21.5200,21.6300,1623,0
FFA,1623,85,17.6200,100,17.5100,17.5850,709,914
JT,1623,100,3.0700,100,3.0000,3.0200,1123,500
LEN.B,1623,100,67.9100,100,67.2800,67.4600,1279,344
NHF,1622,200,12.0100,100,11.9600,11.9500,1589,33
IWL,1620,200,92.7300,100,92.7200,92.6300,1620,0
ANNX,1619,100,25.6100,100,25.1600,25.1600,1619,0
ALGS,1618,16,33.9700,100,33.6300,33.9700,1607,11
ESCA,1618,300,21.1900,300,20.6500,20.7500,1508,110
MIDU,1617,300,48.5300,16,48.4300,48.4400,1601,16
EDIV,1616,100,28.8600,100,28.7800,28.7900,843,773
ARCE,1615,17,38.0100,100,37.7000,37.9100,1615,0
ATNFW,1614,100,0.4600,100,0.3800,0.4299,1614,0
GNTY,1614,22,32.9100,100,32.5500,32.5700,1614,0
AEPPZ,1613,200,49.5600,200,49.3600,49.4300,1613,0
FMBH,1612,200,35.0100,18,34.9100,34.9500,1612,0
STON,1610,700,3.3800,600,3.3000,3.3450,1610,0
THFF,1610,149,40.6600,5,40.5100,40.6100,1610,0
ACET,1609,200,14.3700,45,13.7300,13.9250,1596,13
DLNG,1607,200,2.7200,200,2.6500,2.6900,1507,100
VS,1607,200,8.1000,200,8.0000,8.0700,1607,0
HBIO,1603,100,4.2000,1,4.1600,4.1900,1588,15
VRME,1601,100,4.3400,100,4.2000,4.1900,1601,0
AONE=,1600,200,11.9100,400,11.7100,11.3700,900,700
C-N,1600,200,28.6000,100,28.3800,28.5400,1600,0
CVU,1600,100,4.1100,100,3.9800,4.1000,1600,0
FDT,1600,400,59.8400,200,59.5800,59.4500,1600,0
FILL,1600,300,14.4000,200,14.2900,14.3700,0,1600
SULR,1600,500,34.1700,500,34.1400,33.9400,1600,0
LFTRW,1598,100,2.1700,100,2.0800,2.1300,1298,300
ASAQ,1595,100,10.2800,300,10.1700,10.2200,1595,0
XYF,1594,100,2.3500,100,2.2700,2.2900,0,1594
DIAX,1591,100,15.2500,100,15.1600,15.1700,1591,0
CSTR,1587,100,15.2900,100,15.0900,15.2200,1587,0
SUP,1586,100,5.2200,1400,5.1300,5.1900,1424,162
LBRDA,1585,100,155.1500,2,154.4700,154.6100,1523,62
PTRS,1584,200,6.5500,100,6.5000,6.5500,1439,145
HFEN,1583,100,6.4300,100,6.3100,6.4100,1383,200
PPBT,1583,3,4.6700,100,4.6300,4.6800,1583,0
FHTX,1581,100,19.3700,100,19.1300,19.4000,1581,0
RMR,1579,63,38.6200,200,38.4400,38.6800,1579,0
BCH,1575,100,21.8600,100,21.8100,21.8600,1375,200
CMPR,1575,100,96.1100,43,95.0300,95.2800,1575,0
CRVS,1574,700,3.9600,700,3.8500,3.8800,1574,0
BNTC,1573,100,4.0500,100,3.9000,3.9400,1561,12
LEMB,1571,300,45.1100,200,45.0500,45.0700,1571,0
GSMG,1570,100,3.9600,100,3.8000,3.8600,1500,70
INDL,1570,400,47.1600,15,47.0900,47.0900,1016,554
NOVS,1567,100,25.1400,100,24.7600,24.9400,1567,0
SSTI,1566,100,48.2700,1,47.6600,47.5100,1512,54
SUSA,1566,300,85.2000,300,85.1700,85.1700,1566,0
FET,1565,100,14.7700,100,14.6000,14.6800,1565,0
EES,1561,100,42.1700,200,42.1100,42.0000,1461,100
MIN,1556,100,3.7800,200,3.7700,3.7750,1556,0
USD,1556,100,125.4900,100,125.3900,125.3500,1556,0
AMRK,1551,1,27.9900,100,27.6500,27.9000,1551,0
DTW,1551,100,26.2800,10,26.0000,26.0800,1551,0
PBSM,1547,500,36.3100,300,36.2100,36.2800,1547,0
MMX,1546,100,5.8100,100,5.7800,5.7900,1446,100
BUI,1545,100,25.9200,300,25.7500,25.7200,1545,0
CVLY,1545,56,17.0000,18,16.7500,16.9300,1545,0
PFN,1539,100,10.0600,2,10.0000,10.0100,1061,478
BRZU,1537,10,108.0000,10,107.7800,109.2300,1537,0
IEC,1537,100,16.8300,100,16.6600,16.6500,1237,300
RVI,1537,100,16.0200,80,15.8900,16.0000,1537,0
IMTM,1536,600,39.0300,300,38.8600,39.0050,1236,300
LTRX,1536,100,4.8500,100,4.7500,4.7300,1536,0
CMBS,1535,300,55.2600,100,55.1700,55.2100,1535,0
NSL,1533,100,5.4700,100,5.4100,5.4200,1090,443
DLY,1529,200,19.0900,100,19.0300,19.0100,1229,300
STG,1529,100,1.2600,100,1.1900,1.2300,1257,272
GABC,1525,100,34.3800,100,33.9800,34.1600,1525,0
PWV,1525,800,39.9100,2600,39.9000,39.8200,550,975
ARGT,1524,400,30.7400,500,30.6100,30.7100,624,900
PTH,1523,100,174.3300,19,174.1100,174.7600,1456,67
YLCO,1519,500,19.2000,300,19.1000,19.0600,1001,518
TILT,1516,500,151.5500,2180,151.4700,151.5500,1516,0
SQZ,1515,100,25.4100,100,24.4100,24.2200,1475,40
PIPP+,1510,100,3.2100,100,3.1100,3.2000,1510,0
VIRI,1509,100,7.7800,100,7.6500,7.7000,1506,3
IPV+,1508,100,4.8900,100,4.6700,4.7500,1483,25
HECCW,1505,100,2.5900,100,2.4300,2.5600,1505,0
PTEU,1503,300,22.6000,700,22.5200,22.5000,1503,0
CVCY,1501,43,16.5000,43,16.1000,16.1000,1501,0
JPMB,1500,100,51.0100,600,50.5700,50.8000,100,1400
KXI,1500,1100,57.0300,700,56.8400,56.8600,1500,0
QPX,1500,2500,26.0900,100,26.0500,26.0300,1500,0
SBG=,1500,1500,11.0000,100,10.8900,11.0000,1500,0
CBPO,1497,6,118.4600,100,118.0300,118.4500,1497,0
PSA-M,1493,100,26.4800,100,26.1500,26.2800,1493,0
LOAC,1492,100,12.5500,100,12.3600,12.4150,1492,0
WNEB,1491,100,6.5600,300,6.5000,6.6500,1491,0
CRMT,1490,100,126.8300,200,124.8000,123.9500,1490,0
FSMD,1490,343,30.6700,100,30.6000,30.6700,1490,0
IMAC,1490,2811,1.7800,20,1.7300,1.7550,1490,0
ORLA,1489,300,4.6700,300,4.6400,4.6500,1489,0
USB-Q,1487,100,24.8100,100,24.5600,24.7400,1487,0
JSML,1485,800,67.1700,100,66.7800,67.0200,1410,75
BWFG,1475,100,20.2600,100,19.8900,20.1000,1191,284
SBTX,1472,100,45.6300,25,45.0900,45.1800,1202,270
JHB,1470,100,9.3200,130,9.2500,9.2600,1470,0
VFVA,1469,1500,83.9100,800,83.7500,83.5000,1469,0
DKL,1465,199,37.5900,200,37.4700,37.5900,1350,115
MSON,1464,100,13.7400,100,13.5100,13.6000,1464,0
JCO,1462,800,8.2400,500,8.2100,8.2100,1462,0
BAC-L,1461,200,1526.7000,200,1375.6000,1440.0000,1221,240
IRBO,1461,300,44.4500,300,44.3100,44.4000,461,1000
OSG,1461,243,2.1500,1000,2.1200,2.1500,1261,200
PACXU,1460,100,10.8700,500,10.7600,10.8500,1460,0
RCS,1460,100,6.9700,100,6.8700,6.9300,1400,60
GS-J,1458,100,27.3600,100,27.1100,27.2100,1058,400
SOHO,1458,1000,2.7300,1000,2.6400,2.7000,1458,0
CSWI,1457,7,124.4700,100,124.0500,124.3100,1436,21
BGY,1456,100,6.0400,100,5.9700,6.0000,402,1054
USWSW,1456,200,0.1863,200,0.1015,0.1399,1456,0
PSMB,1455,800,15.6300,101,15.5600,15.5900,1455,0
SBSI,1455,200,33.1200,100,32.8900,33.0800,1454,1
NHC,1453,71,69.0100,100,68.4700,69.0000,1009,444
CDAK,1450,2,26.0500,100,25.7200,25.9900,1450,0
CAC,1448,175,38.0300,100,37.5300,37.9200,1448,0
QMOM,1448,500,59.3500,500,59.2800,59.3000,1448,0
ACIC=,1446,100,11.2400,300,11.1700,11.2300,1446,0
BAUG,1446,15,30.1800,1000,30.0500,30.0600,1446,0
PBUS,1446,100,39.4600,300,39.3800,39.4400,1446,0
CSR,1445,3,72.2000,5,71.7500,72.0700,1431,14
RVSB,1445,100,5.3100,100,5.2400,5.2700,1445,0
BPTH,1442,100,4.3800,100,4.3300,4.3700,1442,0
PLX,1441,100,4.6900,100,4.6300,4.6600,1441,0
ETP-E,1440,100,23.7100,1700,23.5500,23.6300,1440,0
ADX,1438,200,17.8500,100,17.7800,17.7650,921,517
HSKA,1438,100,164.2400,25,162.3500,163.5300,1438,0
HYXU,1438,300,56.6700,3800,56.5200,56.7000,1438,0
BKF,1436,100,57.1400,100,57.0200,57.0700,1436,0
NI-B,1435,100,28.5200,100,28.1000,28.4800,1345,90
SWAN,1435,500,32.8900,100,32.8400,32.8400,1435,0
CLIX,1433,100,97.4800,200,97.0200,97.4100,1431,2
MINC,1432,500,49.0800,500,49.0000,49.1300,1332,100
EET,1431,2000,114.1300,10,113.7500,113.7000,1211,220
NNI,1428,100,70.1300,100,69.8400,69.9100,1428,0
NGAB=,1427,100,11.9900,100,11.8700,11.9100,812,615
PINE,1425,100,16.1800,100,15.9600,16.0400,825,600
XPH,1424,600,53.3800,300,53.3300,53.0700,1324,100
ESG,1422,500,94.5700,11,94.5200,94.5700,1422,0
ANDE,1420,500,25.1800,100,24.8900,25.0300,1419,1
ATLC,1416,100,25.6000,100,25.4600,25.6100,1316,100
JAKK,1414,100,6.3000,100,6.1800,6.2000,1314,100
BKT,1411,100,6.1100,100,6.0600,6.0750,1411,0
TSJA,1411,100,26.1500,100,26.0200,26.1200,1411,0
KINZU,1410,100,10.7400,2,10.6700,10.6500,1410,0
SCU,1410,1,17.7600,200,17.7000,17.7400,1410,0
STXB,1410,200,17.7700,100,17.5900,17.7400,1410,0
ASGI,1408,321,19.9900,200,19.6900,19.7000,700,708
EMXC,1407,400,61.1900,400,60.8600,61.0200,1407,0
PTBD,1405,200,27.6700,200,27.4900,27.5600,1405,0
SFY,1405,2000,14.2600,2001,14.1800,14.2600,1405,0
AGX,1404,100,44.9700,100,44.4200,44.7300,1343,61
TLK,1403,400,24.7600,33,24.6500,24.6900,1400,3
AGZ,1400,200,119.3500,100,119.3000,119.2900,1400,0
GRCYW,1400,200,0.8400,200,0.6900,0.7900,0,1400
LOACW,1400,100,1.5900,300,1.5200,1.6100,1400,0
NUV,1400,100,11.1700,100,11.0700,11.1600,1300,100
NPAWW,1399,100,5.0300,100,4.9100,5.0000,1169,230
ETG,1398,103,18.2100,100,18.1900,18.1900,1398,0
ALCO,1395,186,31.1000,100,30.7400,30.6800,1386,9
GTEC,1394,100,7.6700,100,7.5700,7.5400,1294,100
FCPI,1392,100,26.8100,400,26.7600,26.7100,1392,0
MOHO,1392,100,2.4200,800,2.3000,2.3200,991,401
FMNB,1391,100,13.7800,101,13.7400,13.7700,1391,0
SPD,1391,2500,27.6400,2500,27.6000,27.6200,1391,0
BMRC,1388,16,40.3800,100,39.9100,40.1600,1388,0
FSV,1388,31,140.8800,100,140.4700,140.5300,1288,100
ESLT,1387,200,136.2400,200,134.5800,135.1100,1367,20
NXRT,1387,100,42.8600,100,42.6000,42.8400,1330,57
SMP,1384,100,42.9500,100,42.5600,42.8000,1383,1
GEOS,1383,100,8.9600,100,8.8300,8.8500,1383,0
IETC,1382,300,48.8200,300,48.8000,48.8000,1150,232
AVDG,1380,1626,26.0000,1000,25.9300,25.9900,1380,0
IWV,1379,200,231.5700,300,231.4900,231.6000,1360,19
DMXF,1377,1000,65.1300,1000,64.9700,65.1000,1377,0
PJP,1377,200,76.6800,3,76.6100,76.6100,1377,0
CRU=,1374,100,10.8100,100,10.7100,10.7600,1274,100
PCYO,1372,100,11.5400,100,11.3900,11.4500,1372,0
BUR,1371,100,9.0900,100,8.9700,9.1500,830,541
CEN,1371,100,10.2300,100,10.1300,10.1500,500,871
RESD,1370,1000,29.3700,1000,29.3300,29.3600,1370,0
XLG,1369,100,292.2800,100,292.2100,292.0100,1369,0
RCKY,1368,100,29.8500,100,28.8100,29.2200,1368,0
BFS,1365,100,31.5200,100,31.2100,31.4200,1355,10
CLNN,1365,940,6.8500,100,6.6200,6.6000,1016,349
SMHI,1363,600,3.0400,600,2.9300,2.9900,1363,0
WTMF,1363,400,38.0000,300,37.9600,37.9750,1363,0
AEPPL,1362,100,48.4400,300,48.4200,48.4400,1362,0
LSF,1361,100,42.9700,100,42.4000,43.0000,1251,110
ALLY-A,1360,100,26.4000,100,26.2000,26.3700,1360,0
DSU,1359,100,10.6900,100,10.6300,10.6800,1113,246
BIB,1356,10,100.5200,10,100.4300,100.0700,1356,0
LOMA,1354,100,5.3100,100,5.2200,5.2200,1354,0
YGMZ,1350,100,12.9400,100,12.7200,12.5500,1050,300
AMAL,1349,47,15.0000,100,14.7900,14.8900,1349,0
QUIK,1345,100,4.6800,11,4.5900,4.6500,1345,0
BPT,1344,100,2.9100,200,2.8800,2.8900,1244,100
AMBO,1340,100,2.6500,200,2.5600,2.5100,1250,90
IVH,1340,100,13.1900,100,13.0600,13.1300,600,740
AKICU,1339,50,10.5500,200,10.4600,10.5100,1339,0
PMVP,1339,100,44.2700,1,43.1500,43.2900,1334,5
SCWX,1338,100,14.7200,100,14.5700,14.6600,1315,23
CARE,1331,30,11.1800,400,11.1500,11.1700,1331,0
FPF,1328,200,23.5600,200,23.4800,23.5800,1328,0
EQH-A,1327,100,26.4300,1700,26.2500,26.2850,1327,0
UFO,1327,500,27.9600,300,27.8500,27.9300,1186,141
BGSF,1320,100,13.4500,100,13.3200,13.2900,1320,0
BHFAN,1320,100,26.5400,100,26.2600,26.4000,1320,0
BHB,1316,100,22.3600,5,22.1200,22.2500,1112,204
TIG,1316,100,15.2900,100,15.0800,15.3600,1316,0
BATRA,1315,100,26.0800,100,25.7900,25.8400,1215,100
BAPR,1312,400,29.9100,710,29.7800,29.7800,1312,0
DCF,1310,200,8.8200,200,8.7500,8.8200,468,842
KOSS,1307,100,3.5800,100,3.4200,3.4800,1307,0
USXF,1306,100,32.4600,100,32.3000,32.2300,1306,0
LMRK,1305,100,12.3700,214,12.3400,12.3300,1305,0
PVL,1304,100,1.1000,400,1.0700,1.0700,1304,0
NKG,1302,100,13.0300,100,12.8600,13.1000,1302,0
AWP,1301,600,5.4200,100,5.4000,5.4100,1301,0
GVAL,1301,300,22.0900,300,22.0300,22.0000,1301,0
JHML,1301,1700,48.8500,2700,48.8300,48.8100,1301,0
CWI,1300,900,29.2300,1400,29.2100,29.2100,1300,0
DXYN,1300,500,3.4900,100,3.4200,3.4900,1300,0
FTCVU,1300,100,11.3100,100,11.1500,11.1300,1300,0
JPM-G,1300,100,25.7800,100,25.5500,25.6700,1090,210
PSB,1300,1,136.8100,100,135.9100,136.4700,1300,0
TFC-F,1300,1200,25.3000,2675,25.2900,25.2900,1300,0
TRVI,1300,300,3.0600,200,2.9600,3.0000,1300,0
USCI,1300,1200,33.5500,1000,33.4200,33.5000,1300,0
VSPRW,1300,100,2.5500,100,2.4700,2.5700,1300,0
JTA,1298,100,9.9400,541,9.8900,9.9250,267,1031
GHVIU,1292,100,11.2400,100,11.0700,11.2300,792,500
VFMO,1291,1500,122.9000,700,122.8100,122.8700,1291,0
FONR,1290,100,18.6200,100,18.3600,18.5000,1290,0
GOF,1290,15,20.0500,100,19.9100,20.0000,990,300
MORF,1289,100,29.9300,200,29.6300,29.5900,1289,0
SCPS,1287,100,13.1300,100,12.9000,12.9800,1287,0
PFHD,1284,90,16.4900,100,15.6100,16.4700,1284,0
VXZ,1284,100,32.0000,100,31.9300,31.8600,1284,0
KWR,1283,100,270.4000,1,269.8700,272.4000,1274,9
BSRR,1278,100,24.1300,100,24.0100,24.0600,1278,0
SMTI,1278,100,44.6100,37,40.6300,41.8500,1178,100
IEIH,1276,500,34.2600,600,34.2200,34.1700,1276,0
APEI,1272,100,30.5700,100,30.2500,30.3900,1272,0
BBRE,1272,200,79.7700,800,79.7100,79.7900,1272,0
NP,1270,100,55.1700,100,54.6000,54.8400,1270,0
T-A,1269,100,26.5300,100,26.2800,26.3700,613,656
IMOM,1268,600,36.5200,300,36.4000,36.4400,1268,0
CBTX,1265,171,27.5700,200,27.4000,27.2000,1265,0
PTNQ,1265,200,53.1100,700,53.0900,53.0800,1265,0
FCBC,1261,100,22.7900,100,22.3200,22.3100,1261,0
TNC,1261,100,74.5000,72,74.2500,74.4800,1260,1
PNOV,1257,300,29.2300,300,29.1500,29.2400,1257,0
BBU,1255,100,38.0400,100,37.9100,37.9600,1255,0
SAFE,1255,1,75.6100,100,75.0500,75.4300,1155,100
FMAT,1253,900,41.5200,1200,41.4900,41.4100,1053,200
WFH,1253,200,70.5300,200,70.4600,70.4400,1253,0
RICK,1252,100,42.5700,8,41.9900,41.9300,1252,0
SRT,1252,200,7.9600,200,7.8400,7.9000,1252,0
DGII,1251,100,19.6800,100,19.4900,19.6400,1251,0
NJAN,1250,600,38.6600,700,38.5400,38.6300,1250,0
ZROZ,1250,100,153.9600,100,152.4400,153.2150,650,600
INS,1247,200,40.1800,1,39.7700,40.4800,1037,210
FRDM,1244,500,34.4700,9101,34.4500,34.4500,1244,0
WFHY,1243,300,52.5800,483,52.5000,52.5700,1243,0
RBB,1238,100,17.7600,100,17.5900,17.6900,1238,0
CZNC,1236,100,20.3500,100,20.0400,20.1000,1236,0
IBBJ,1236,500,37.0600,400,36.9300,36.9400,1236,0
HPS,1235,426,16.9800,100,16.9000,16.9750,1135,100
ETY,1231,500,12.5600,500,12.5500,12.5600,731,500
PMO,1230,100,13.7800,100,13.6300,13.7400,500,730
FPX,1228,200,127.6900,200,127.5900,127.6600,1228,0
MPX,1228,100,15.9800,100,15.7500,15.9500,1228,0
MCRI,1221,100,61.3100,45,60.9100,61.0100,1221,0
NAD,1221,300,15.1600,400,15.1500,15.1500,1140,81
TNP,1221,100,8.9900,200,8.9000,8.9300,1221,0
ISTB,1219,300,51.6600,2100,51.6500,51.6500,1219,0
MBOT,1219,100,8.1900,300,8.0400,8.1300,1219,0
CIM-D,1218,100,23.5800,100,23.2600,23.4500,1218,0
SLY,1214,38,86.8300,138,86.7300,86.7000,1163,51
CDC,1210,700,55.6400,4710,55.6100,55.6200,1210,0
FFTY,1208,500,46.1800,5340,46.1500,46.1400,1008,200
METC,1207,400,3.1900,400,3.1000,3.1400,727,480
BY,1206,100,16.5400,100,16.3800,16.4450,1206,0
STN,1205,100,35.0500,100,35.0100,35.0200,1105,100
ANIP,1204,100,31.9400,100,31.7000,31.7500,1204,0
CHE,1204,1,547.5400,100,544.2200,548.0700,1102,102
STRS,1203,300,25.7600,100,25.0000,25.1000,1184,19
REZ,1201,200,68.2300,100,68.1800,68.0950,1167,34
ACAMU,1200,1,12.6000,100,12.2000,12.5000,0,1200
AVAN+,1200,100,2.1400,100,2.0200,2.1400,1200,0
CIM-A,1200,100,24.4200,100,24.1500,24.2400,1200,0
CYTHW,1200,100,2.2700,100,1.7700,1.7900,1200,0
DGRS,1200,1000,41.7200,1000,41.5500,41.9000,1200,0
ESSCR,1200,100,0.5200,100,0.4200,0.4810,1200,0
ESSCW,1200,100,0.7750,200,0.7100,0.7750,1200,0
FREEW,1200,100,1.6100,100,1.5300,1.5700,1200,0
GIK=,1200,400,20.2000,900,19.2700,20.1400,1200,0
GRP=,1200,100,60.8400,100,60.7300,60.7500,400,800
GSAQU,1200,100,10.4600,100,10.4100,10.4100,1200,0
HZON=,1200,200,11.3400,900,11.2500,11.3400,1200,0
IHD,1200,100,8.1300,100,8.0400,8.2000,220,980
LDP,1200,200,25.9600,200,25.6800,25.7800,1200,0
NAC,1200,200,14.9300,200,14.8600,14.8700,1100,100
NFJ,1200,200,13.7300,100,13.7000,13.7300,1000,200
OPNT,1200,100,9.2800,100,9.1200,9.2000,1200,0
PHYL,1200,300,40.9700,200,40.9300,40.9350,1200,0
SPXB,1200,186,92.7300,166,92.6400,92.7000,1200,0
GRAY,1198,92,30.4000,100,29.6500,29.9000,1147,51
RTM,1197,600,147.3500,600,146.1000,146.9700,876,321
RBNC,1193,100,19.8000,42,19.6200,19.7100,1193,0
CTEK,1192,300,2.1100,100,2.0800,2.0800,1192,0
LEAF,1192,1500,5.3900,1500,5.2900,5.3200,1192,0
SRACU,1191,100,29.0000,500,27.8200,30.4200,1190,1
GHYG,1190,4200,50.9100,37,50.8300,50.8600,1090,100
SCHM,1189,200,72.1300,300,72.0900,72.1400,1189,0
CET,1188,200,34.2700,100,33.9300,34.1700,622,566
MGRB,1184,100,25.8100,300,25.6200,25.6500,770,414
PIPR,1183,1,101.5000,5,101.1000,101.5000,1175,8
VINCW,1183,100,4.6900,100,4.3600,4.3400,1183,0
DIG,1182,300,90.6200,200,90.5100,90.1900,1154,28
BNDC,1181,200,26.8200,200,26.6600,26.7500,1181,0
GEM,1179,100,41.1600,100,41.1100,41.1300,1079,100
XMPT,1175,300,28.5300,300,28.4700,28.4300,1175,0
CEREW,1173,400,4.0000,100,3.9000,4.0000,1173,0
DUC,1171,300,9.9400,200,9.8500,9.8800,886,285
EBAYL,1168,100,25.9700,300,25.8500,25.8700,1168,0
MXI,1162,900,85.4500,200,85.2300,85.3000,1162,0
EWGS,1159,400,79.5000,200,79.3400,79.4200,1159,0
BXG,1158,100,7.5600,100,7.4200,7.5500,1158,0
EMPW=,1157,244,10.6600,900,10.5800,10.6350,1157,0
HUSA,1155,11,1.9600,1900,1.9200,1.9450,1055,100
VMO,1155,200,12.9500,100,12.8900,12.9350,1155,0
DEM,1151,100,42.9100,500,42.7200,42.8600,1109,42
ALTM,1150,100,48.3100,100,47.8200,48.2200,1145,5
MLN,1150,400,21.8100,617,21.8000,21.8000,1150,0
TWND,1148,200,10.4800,100,10.3600,10.3700,1066,82
AP,1143,100,6.8800,100,6.7800,6.8800,1054,89
DCTH,1140,100,16.9600,100,16.8100,16.8900,766,374
DSE,1137,100,5.5200,200,5.4400,5.4500,324,813
FXA,1137,300,77.3100,1700,77.2900,77.1500,1137,0
CCB,1136,217,21.4800,100,21.0200,21.4000,1136,0
FBRX,1136,100,39.2600,100,38.6300,38.9300,816,320
FMO,1136,100,6.9400,100,6.8300,6.8900,1136,0
PCGU,1136,100,118.7700,100,118.4200,118.4700,336,800
PNFPP,1130,60,27.4900,100,27.4500,27.4900,1130,0
INSI,1129,100,21.6800,100,21.3000,21.2500,1129,0
WFC-A,1126,100,25.9000,100,25.6100,25.8300,1126,0
PVBC,1125,100,11.9400,100,11.8400,11.8500,1125,0
HBB,1124,100,17.4100,100,17.0200,17.2500,1124,0
LOKB=,1124,100,11.3400,100,11.1600,11.1000,924,200
CTR,1122,100,16.8000,200,16.7000,16.6600,702,420
AFI,1120,100,4.0900,100,4.0200,4.0000,1120,0
FV,1117,100,43.2100,6800,43.1700,43.1800,1117,0
RDI,1116,100,7.3600,100,7.2600,7.3600,1116,0
SPRQ+,1115,183,2.9400,100,2.7500,2.7600,1115,0
QELLU,1112,400,15.2500,700,15.1700,15.2000,1012,100
HOOK,1111,100,12.4000,100,12.1700,12.2400,1111,0
NUM,1111,200,15.0000,100,14.9100,14.9900,799,312
LQDI,1110,7100,29.2800,10,29.1500,29.2500,1110,0
MKL,1110,10,1002.5500,10,997.0400,1002.1500,1105,5
PHDG,1110,2000,34.2100,2400,34.1200,34.1700,1110,0
PEY,1109,2100,18.0900,2900,18.0800,18.0500,909,200
SENEA,1109,83,36.7700,100,36.3600,36.3700,1109,0
PSCE,1108,100,5.2200,500,5.1800,5.1600,1108,0
UTL,1107,100,41.6300,100,41.1300,41.2800,1105,2
PKX,1105,100,61.8700,10,61.6800,61.4400,1105,0
TA,1105,100,32.8200,100,32.3500,32.5700,1101,4
BBSA,1104,338,26.0900,8240,26.0600,26.0700,1104,0
JVA,1104,100,5.6500,100,5.4900,5.6000,1104,0
CRD.A,1103,20,7.9500,100,7.8600,7.9500,1103,0
MBIN,1102,100,30.8200,154,30.5100,30.3300,1102,0
AKU,1100,100,2.9800,100,2.9400,2.9400,1100,0
DGL,1100,100,54.3000,1000,54.1100,54.2400,500,600
DHCNL,1100,100,24.6700,500,24.4000,24.4600,1100,0
EPWR=,1100,100,10.4100,200,10.3400,10.3800,1100,0
F-C,1100,100,26.3700,100,26.3200,26.3500,1100,0
FIIIW,1100,100,3.5300,100,3.3700,3.4000,1100,0
IBMN,1100,300,28.2000,300,28.1400,28.1800,1100,0
NHS,1100,210,11.8100,200,11.7500,11.8000,400,700
NS-B,1100,100,17.8900,100,17.6800,17.7800,980,120
USAP,1100,100,7.7800,100,7.6900,7.7800,1100,0
PKOH,1099,12,31.9000,7,31.2200,31.5600,1099,0
NACP,1098,3902,29.6400,400,29.5700,29.6000,1098,0
SPRT,1098,4761,2.1500,500,2.0800,2.1100,898,200
ACAC,1092,100,11.4100,100,11.0300,11.2600,400,692
GPX,1092,100,12.4500,100,12.2100,12.4300,1092,0
GAIA,1091,100,9.7500,100,9.6900,9.7600,1091,0
PWB,1091,400,70.2500,300,70.2200,70.2600,1091,0
JRO,1089,200,9.1900,100,9.1400,9.1800,1089,0
EBIZ,1080,500,34.6200,100,34.5900,34.5500,1080,0
IMTX,1077,100,11.2100,100,11.0600,11.2350,1077,0
JOUT,1077,100,114.2000,100,112.5500,113.8800,1077,0
DUDE,1075,500,28.5600,100,28.4900,28.4600,1075,0
KIO,1075,100,14.7600,100,14.6300,14.6900,1075,0
GENC,1074,100,12.8800,100,12.6000,12.7200,1074,0
RMBI,1074,215,13.7200,100,13.5300,13.5900,1074,0
ABST,1072,100,13.2000,200,13.1700,13.1800,1072,0
INBK,1064,100,32.4200,16,31.6200,32.2900,1064,0
IWY,1064,100,136.4600,100,136.4400,136.4100,1064,0
USOI,1064,100,4.8700,411,4.8400,4.8550,1064,0
TCHP,1063,4000,28.7800,4000,28.7300,28.7600,1063,0
QADA,1059,100,68.4500,89,67.9700,68.0400,1019,40
UGA,1059,1800,26.7000,1800,26.6700,26.6400,1059,0
ADME,1057,6000,36.6500,6000,36.6000,36.6200,1057,0
EARN,1056,100,12.4500,100,12.4000,12.4600,991,65
SGTX,1056,100,34.8500,100,34.2200,34.3600,1052,4
AVDV,1052,100,59.4500,100,58.9200,59.1700,1052,0
BOCH,1051,83,10.1200,100,9.9700,10.1200,1023,28
GRSVW,1051,100,2.5200,100,2.4200,2.4600,1051,0
CHAU,1050,15,48.6600,100,48.5900,48.4000,1050,0
ISSC,1050,100,6.3900,100,6.2400,6.3400,100,950
RMO+,1050,100,8.1400,100,7.8500,8.2400,650,400
YMTX,1050,100,20.6300,100,20.2700,20.5700,1050,0
FRC-K,1049,100,25.5400,100,25.2300,25.4400,949,100
KAI,1049,100,150.4800,100,148.1100,149.7800,921,128
RELL,1049,100,6.2700,100,6.1400,6.0300,1049,0
NNA,1047,100,3.7000,100,3.6400,3.6600,1047,0
FBMS,1045,200,32.2000,1,32.0100,32.1800,1045,0
LAWS,1045,1,49.9500,100,49.2100,49.3200,945,100
AMOT,1044,100,50.7500,100,49.3800,50.8200,1044,0
SHSP,1043,16,19.9200,100,19.5100,19.6000,1043,0
ZCMD,1043,100,1.9800,57,1.9100,1.9400,1043,0
RCMT,1042,22,2.5000,200,2.4400,2.4400,1042,0
INZY,1040,200,26.8900,100,26.4200,26.9100,1039,1
HTGM,1038,100,7.2200,100,7.0800,6.9800,938,100
MS-A,1038,100,24.9600,100,24.7600,24.8700,1038,0
ONCR,1038,100,26.8000,200,26.0100,26.3000,1034,4
CVCO,1037,196,195.9200,100,194.9700,195.9200,1037,0
BELFB,1034,100,16.6000,100,16.5000,16.4900,1034,0
OPBK,1034,365,7.5400,100,7.5000,7.5400,1034,0
CMLS,1033,100,9.5400,100,9.4200,9.4800,1033,0
IID,1031,600,5.3300,1,5.3100,5.3200,1031,0
PLRX,1031,100,26.5300,110,26.0400,26.0600,1031,0
BJUL,1030,2738,30.3000,400,30.2400,30.3000,1030,0
CEM,1030,100,19.5500,200,19.3700,19.5200,930,100
LDL,1029,100,33.1800,8,32.8700,32.9900,1029,0
PICO,1028,200,9.4300,137,9.3600,9.3700,1028,0
DSL,1025,100,16.8400,100,16.7000,16.7700,759,266
KVHI,1025,97,12.5000,100,12.4500,12.5000,1006,19
CCNC,1022,300,2.0000,100,1.9500,1.9100,1022,0
FLRG,1022,500,21.9600,500,21.9300,21.9700,1022,0
CIG.C,1020,100,3.0000,200,2.9300,2.9700,1020,0
CPK,1020,100,103.3700,4,102.6900,102.7600,1020,0
FSTA,1019,800,39.6300,2200,39.6200,39.6700,300,719
SXI,1018,50,85.4100,100,84.3900,85.2200,1018,0
GBR,1017,675,2.3400,100,2.2800,2.3300,992,25
CARZ,1016,100,58.3800,1,58.0000,58.3700,1016,0
SND,1016,900,1.9100,100,1.8500,1.8600,916,100
BFZ,1014,200,14.0400,1200,14.0000,14.0400,714,300
AGYS,1013,100,43.4600,100,43.1400,43.4000,1011,2
DBOC,1010,102,27.5100,100,27.3700,27.4100,1010,0
MPB,1010,13,22.7600,13,22.5700,22.5200,1010,0
CNTG,1008,100,12.1100,100,11.9100,12.0100,1008,0
FMS,1006,200,41.9900,100,41.7700,41.8400,991,15
BLPH,1003,100,7.9300,100,7.8500,7.9100,1003,0
CHI,1001,100,13.9900,100,13.9200,13.9900,1001,0
TSIAU,1001,100,11.0400,100,10.8300,10.8800,1001,0
ARKOW,1000,100,1.2900,5,1.1700,1.2500,1000,0
BML-G,1000,100,22.4900,100,22.0600,22.3650,1000,0
BRBS,1000,100,20.0700,100,19.5300,20.0000,1000,0
CHPM,1000,100,10.5800,100,10.4300,10.5000,0,1000
EHI,1000,800,10.2000,100,10.1300,10.2000,0,1000
ERESU,1000,500,11.3100,600,11.1100,11.0300,1000,0
FNOV,1000,100,35.6800,500,35.5800,35.6500,1000,0
KERNW,1000,100,1.6100,100,1.4800,1.5200,1000,0
LRGF,1000,2100,39.4100,2000,39.4000,39.3100,700,300
MEDS,1000,100,6.0300,100,5.9200,5.9300,1000,0
METXW,1000,200,0.3705,200,0.1728,0.2500,1000,0
MLACW,1000,100,1.4600,100,1.3400,1.4300,0,1000
NGACW,1000,130,1.8900,100,1.8200,1.9200,0,1000
PBS,1000,500,48.2400,100,48.1800,48.2000,1000,0
RFDI,1000,600,66.5000,300,66.2100,66.1400,1000,0
SPXX,1000,100,15.4600,100,15.2800,15.4500,900,100
UCON,1000,200,26.7200,200,26.6300,26.6800,1000,0
VPV,1000,200,12.6800,100,12.6000,12.6500,1000,0
YSACU,1000,100,11.0300,100,10.7600,10.8950,800,200
BEP-A,999,900,26.7000,100,26.4500,26.6500,999,0
HBMD,995,100,13.2500,100,13.2200,13.2500,995,0
OSIS,994,100,93.2400,100,92.2600,92.5500,994,0
TYO,988,180,8.3400,300,8.3000,8.3100,808,180
ESQ,987,24,23.8200,100,23.5100,23.7000,943,44
FBT,985,400,178.5000,400,178.3500,178.7100,955,30
SOLN,980,200,51.0200,200,50.8200,50.8600,980,0
ADMS,979,200,4.5900,100,4.5400,4.5600,979,0
PDEX,978,100,32.2000,100,31.4000,31.7500,942,36
WSBF,978,100,19.0900,100,18.9700,18.9700,978,0
CBNK,977,77,14.2800,13,14.0500,14.1500,977,0
DVLU,977,500,19.4500,500,19.4200,19.4400,977,0
GRCL,977,100,22.6600,55,22.0100,22.3100,877,100
CRC,976,100,24.9500,100,24.7400,24.8800,976,0
AROW,975,100,31.2200,100,30.8100,30.9400,975,0
HCI,974,103,54.9900,100,54.3500,54.9400,974,0
PULS,968,200,49.9000,300,49.8900,49.9000,968,0
INVE,961,100,8.0800,100,8.0100,7.9800,961,0
GRN,960,100,68.0000,100,67.3300,67.9800,960,0
MYI,959,100,14.2600,100,14.1800,14.1800,959,0
MEXX,958,100,66.2300,300,65.2000,65.3900,848,110
APOP,957,100,3.2100,100,3.1100,3.1600,957,0
XHE,957,32,121.8800,132,121.7200,122.1200,829,128
GFN,955,100,8.8600,100,8.7100,8.7400,955,0
PSA-F,954,100,26.3000,100,26.0500,26.2000,938,16
UGL,950,400,65.3400,400,65.3100,65.3400,950,0
NRZ-C,949,100,21.5700,100,21.3700,21.5600,949,0
PEI-B,948,100,12.2600,100,12.0800,12.3300,648,300
NVR,945,1,4442.0900,30,4428.0200,4432.5000,832,113
DFHY,940,100,25.2600,200,25.2200,25.2200,940,0
ETACU,940,100,11.3600,1000,11.3100,11.3000,940,0
TTP,939,100,19.3300,100,19.1300,19.2000,939,0
NMY,937,100,14.1200,100,14.0200,14.0500,937,0
ACP,934,100,11.1100,100,10.9800,11.1000,934,0
BST,932,200,54.3700,100,53.9900,54.2400,792,140
ENOB,931,200,3.2400,500,3.1600,3.2100,931,0
IBMQ,930,7200,27.6100,7500,27.5400,27.5500,930,0
ADCT,926,186,32.1200,100,31.4200,31.6800,922,4
MOTV=,924,100,11.1300,100,10.9700,11.0600,824,100
VIOO,924,100,183.1500,19,183.0000,182.9500,848,76
EML,922,100,25.4400,1,25.0500,25.1100,922,0
VSEC,922,100,40.3400,100,38.8600,40.1600,922,0
VRNA,921,100,7.9400,100,7.7700,7.8400,921,0
UNTY,919,100,18.4500,25,17.9900,18.1500,919,0
BRT,918,100,15.5600,200,15.3100,15.2300,918,0
CRVL,917,1,104.7400,101,104.2400,104.4000,917,0
GWRS,916,100,16.5200,100,16.2800,16.3900,916,0
NRIM,916,100,34.3000,100,33.7700,34.0750,916,0
VGAC=,913,400,15.3300,900,15.0500,15.2400,913,0
BIVI,911,1,35.9900,200,33.5700,35.9800,911,0
TGP,911,100,12.9000,100,12.8100,12.8800,911,0
PRI,910,100,138.9300,100,137.8400,138.6700,910,0
WFC-L,910,200,1530.1500,10,1447.0100,1440.0000,910,0
SHG,909,100,30.6100,200,30.4300,30.4800,909,0
WRB-F,909,100,26.3400,100,25.9200,26.2000,900,9
FCNCA,908,2,637.0900,1,634.7200,634.9000,796,112
PFH,908,100,25.6600,100,25.4500,25.5600,908,0
NFH,907,100,8.6500,100,8.5700,8.6300,900,7
PPT,905,200,4.6800,100,4.6600,4.6650,905,0
BBSI,904,100,68.5300,100,67.5400,67.5700,892,12
BGB,904,100,13.1100,100,13.0600,13.1150,710,194
FLCH,904,300,35.9100,100,35.7200,35.8900,904,0
HWCC,904,100,3.7300,100,3.6500,3.8000,904,0
AIH,900,200,5.0500,100,4.9700,5.0000,900,0
EXN,900,100,2.7400,100,2.7100,2.7300,900,0
FTF,900,100,9.5000,100,9.4000,9.4400,200,700
HCARW,900,100,1.3900,100,1.3000,1.3500,900,0
IGACU,900,300,11.6200,800,11.5600,11.5600,900,0
JO,900,100,37.2000,100,37.0000,36.9900,900,0
KLAQU,900,200,10.4200,200,10.4000,10.4200,900,0
PFM,900,500,33.1600,100,33.1400,33.1800,900,0
PRN,900,100,104.1200,300,103.0100,103.2400,900,0
TSIA,900,100,10.4300,3,10.3700,10.3700,900,0
TWNKW,900,100,1.3900,100,1.2900,1.3300,900,0
VCVCU,900,100,11.6400,200,11.5100,11.5500,900,0
XT,900,500,60.7300,495,60.6800,60.6700,700,200
ASLEW,899,200,3.0300,100,2.9300,3.0100,899,0
SNFCA,898,100,9.0300,100,8.9400,8.9900,898,0
CTO,896,100,46.2000,2,45.0400,46.0500,890,6
IGM,895,100,361.7400,100,361.5900,360.9300,895,0
HFFG,893,1500,7.3000,100,7.2100,7.2600,893,0
BWAC,890,100,10.4500,100,10.3700,10.3900,890,0
SGC,890,100,24.8500,100,24.4600,24.5400,890,0
YORW,888,100,45.0900,100,44.9000,45.0700,888,0
RM,887,200,32.2700,8,31.7100,31.6800,887,0
ICD,886,100,3.8500,100,3.8000,3.8600,886,0
ISTR,886,39,16.9300,100,16.8200,16.8900,829,57
VFQY,882,2400,105.5600,800,105.4500,105.4400,882,0
HBP,881,200,3.4800,200,3.3600,3.4400,876,5
IDHD,880,202,26.8200,300,26.6300,26.6500,880,0
CWEB,877,9,80.7800,10,80.6200,80.5900,877,0
OOMA,876,100,14.9800,100,14.7800,14.8300,876,0
PKBK,875,100,18.0200,60,17.8100,17.8800,875,0
CFIIU,874,400,12.9400,900,12.8100,12.9500,764,110
RFL,872,100,24.3800,100,24.0600,24.1900,842,30
VKI,872,100,11.4800,100,11.3700,11.4500,872,0
KFRC,871,100,44.9500,100,44.4700,44.7800,745,126
NATR,871,500,15.6200,110,15.5000,15.5100,871,0
GAA,870,300,30.1200,300,30.0200,30.0400,870,0
GTIP,868,3400,57.5400,3700,57.5200,57.4700,868,0
SMDV,868,300,59.3300,500,59.2800,59.0800,868,0
AEHR,866,100,2.4100,100,2.3700,2.3100,866,0
FFC,865,100,22.6400,100,22.4200,22.5300,865,0
KBSF,862,100,3.4000,100,3.2900,3.2200,862,0
F-B,860,100,26.8200,168,26.6400,26.6800,260,600
NOCT,860,400,36.7000,200,36.5100,36.5000,860,0
SMBC,860,119,31.8900,19,31.6100,31.8600,860,0
FVT=,858,100,11.0400,100,10.9100,11.0000,858,0
PME,857,100,1.7800,64,1.7300,1.7300,657,200
IDLV,856,100,30.4000,4700,30.3800,30.3700,856,0
KF,855,100,45.0600,100,44.6300,44.7500,443,412
XTN,854,300,74.6500,300,74.5900,74.6100,854,0
USM,853,100,33.5600,100,33.4800,33.5100,853,0
BCML,850,200,15.4100,100,15.3200,15.3200,850,0
PDSB,850,1800,2.8500,1800,2.7600,2.8100,850,0
OACB,849,100,11.0300,100,10.8800,10.9550,849,0
SQFT,849,100,4.0100,100,3.9200,3.9800,849,0
TFC-G,849,300,25.3400,700,25.2900,25.3400,849,0
SYBT,847,200,42.0200,1,41.7200,41.6900,845,2
THRY,845,5,18.9800,200,18.7000,19.0600,845,0
WLKP,845,100,21.9400,100,21.7100,21.8000,845,0
EDTK,844,300,3.3900,100,3.3100,3.3700,844,0
MFNC,843,18,13.2200,100,13.0500,13.1600,843,0
UEIC,842,100,59.6100,48,58.8000,59.2600,842,0
MNSB,841,24,17.9500,100,17.7100,17.8500,841,0
NVEE,841,100,93.2700,100,92.1700,93.3800,841,0
ONLN,840,200,84.9200,100,84.2800,84.4500,840,0
BTAL,839,100,18.5900,200,18.5200,18.5300,839,0
EPHE,839,100,32.3700,5,32.3000,32.3300,839,0
EVM,839,100,11.5700,361,11.5200,11.5200,339,500
KARS,836,200,45.6000,300,45.3600,45.5100,836,0
XFLT,836,1,8.1200,100,8.0700,8.0600,836,0
GMOM,830,300,27.2300,300,27.1700,26.9400,830,0
HURC,830,100,32.7300,15,31.4600,31.8500,830,0
VFL,829,376,13.4400,100,13.2500,13.3000,207,622
ITRG,828,200,3.6100,100,3.5800,3.6500,828,0
ATMP,826,500,12.8700,2700,12.8400,12.8300,800,26
ACNB,825,49,26.8300,100,26.2400,26.5700,825,0
CFG-D,825,100,27.4700,100,27.2400,27.4000,825,0
GLU,822,100,18.7200,203,18.5700,18.6800,801,21
AHT-G,821,100,14.3600,100,13.8000,14.4100,821,0
CCM,821,367,3.7000,100,3.6300,3.6700,821,0
POWRU,820,100,10.5600,200,10.4900,10.4500,820,0
VINC,820,100,21.9400,100,21.4800,21.5950,480,340
NULC,819,700,36.2400,800,36.2100,36.2500,819,0
SMDD,819,180,10.1400,1000,10.1100,9.7000,819,0
TDIV,819,400,52.2300,300,52.2100,52.1500,819,0
JRS,818,100,8.5000,1000,8.4300,8.4400,418,400
WIP,818,600,58.2700,600,57.8400,57.9750,818,0
CAPL,815,100,18.5200,100,18.1900,18.4550,815,0
NODK,815,200,17.1000,100,16.6000,17.0400,810,5
IIAC+,813,100,1.9200,100,1.3400,1.8500,233,580
DFEB,812,100,32.6000,1100,32.5500,32.5500,812,0
FTXN,812,300,13.2800,200,13.1500,13.1200,812,0
MNP,812,218,15.0300,100,14.9500,15.0100,208,604
SMMD,811,500,60.8400,700,60.7100,60.7900,811,0
NRZ-B,806,100,22.9400,100,22.6800,22.8000,800,6
TPVG,806,10,13.6100,700,13.5200,13.5800,806,0
NMZ,805,492,14.3100,100,14.2500,14.3000,805,0
EVOL,803,200,2.2800,800,2.2200,2.2300,803,0
MACK,803,200,7.5800,200,7.4900,7.5800,803,0
VCR,803,200,294.8800,200,294.7900,294.8600,803,0
CEPU,802,100,2.4400,500,2.3800,2.3900,802,0
COMT,801,200,27.9000,3,27.8700,27.9000,801,0
DVD,801,500,2.4700,100,2.4200,2.4100,801,0
ISNS,801,100,4.5400,200,4.4500,4.4200,801,0
MRLN,801,100,11.8000,100,11.7200,11.7700,801,0
AFB,800,100,14.2200,100,14.1400,14.1400,700,100
BTT,800,100,25.6000,100,25.3500,25.4400,800,0
CHPMW,800,100,1.4900,100,1.3900,1.4300,800,0
ECON,800,400,30.5000,400,30.3300,30.3100,400,400
FAII+,800,100,3.2300,100,3.0600,3.0900,800,0
GWGH,800,100,7.1500,100,7.0700,7.0900,800,0
HTRB,800,1537,41.5700,200,41.5200,41.5500,600,200
IVA,800,100,19.1600,100,18.5600,18.7000,800,0
JIH+,800,100,2.7800,100,2.7000,2.7000,800,0
JP,800,100,2.0200,100,1.9600,2.0000,800,0
KSMTW,800,100,1.3400,100,1.1800,1.2500,0,800
LCAPW,800,100,1.6400,100,1.4800,1.5200,600,200
MACUU,800,200,11.5400,100,10.7100,10.9100,800,0
MNTX,800,100,5.6400,100,5.4800,5.5900,800,0
OMEX,800,100,6.8900,100,6.7700,6.8500,800,0
PSMD,800,3000,21.1200,3000,21.0000,21.0100,800,0
PXF,800,100,44.6100,100,44.5800,44.5200,800,0
SCHW-C,800,200,25.5400,100,25.3500,25.4500,800,0
SRLP,800,100,20.4200,400,20.0800,20.1100,700,100
TFJL,800,400,24.1700,300,24.0700,24.1600,800,0
WFC-Q,800,100,26.6400,100,26.3200,26.4800,800,0
EBMT,795,100,20.7100,36,20.4100,20.4500,795,0
PBPB,794,600,4.9900,200,4.8800,4.9100,794,0
EBTC,792,100,27.9200,48,27.7100,27.7500,792,0
TELA,792,100,14.8100,100,14.4500,14.5600,792,0
C-J,791,100,28.4100,100,28.1200,28.3500,512,279
TFC-H,791,100,25.8100,100,25.6500,25.7000,791,0
NVEC,787,70,68.9900,100,68.2000,68.2200,787,0
ATH-C,785,100,28.0300,100,27.6900,27.9800,765,20
NRUC,784,100,27.3800,500,27.1600,27.2300,683,101
IJT,782,500,124.7800,200,124.6700,124.7100,682,100
RMGBU,780,100,11.3500,100,11.2600,11.3500,750,30
PILL,779,200,27.2200,200,27.0600,26.8000,779,0
PBFS,777,100,10.7700,100,10.3900,10.7500,777,0
IVOO,776,200,165.9200,130,165.8100,165.7200,776,0
DWSN,775,100,2.5900,200,2.5000,2.5600,775,0
FGBI,774,6,17.0000,1,16.6000,16.4300,774,0
RA,773,100,18.6300,1,18.5000,18.5500,773,0
VIHAU,771,400,17.0600,500,16.4500,17.0000,771,0
VRTS,769,100,222.8700,32,220.1800,221.0700,769,0
ONEQ,766,100,526.9900,200,523.9500,524.5000,751,15
CCNE,765,100,22.9700,7,22.7100,22.7100,765,0
IGRO,765,600,64.8100,378,64.5600,64.7500,765,0
MCBS,764,55,14.7200,100,14.6000,14.7200,764,0
CTG,763,100,6.9800,100,6.6700,6.8500,763,0
MORN,763,100,232.2800,100,230.9000,232.4400,663,100
SPOK,763,2,12.3300,280,12.2500,12.3100,559,204
EFAD,762,800,43.9000,800,43.7600,43.8800,762,0
HWKN,762,100,53.7100,100,53.0900,53.4000,696,66
SIEB,762,300,3.6600,1,3.6000,3.6500,762,0
VRDN,762,22,20.4000,100,20.2100,20.3000,762,0
VIIAU,761,100,10.6700,100,10.6100,10.6400,759,2
NEU,760,2,424.0000,100,421.1000,422.9400,685,75
MSA,758,100,163.9600,32,162.9900,163.2300,658,100
KBWY,757,1100,20.9900,800,20.9600,20.9800,747,10
PWFL,756,100,8.5400,100,8.4600,8.4900,251,505
MTCR,755,100,9.4300,100,9.1800,9.2900,755,0
LGHLW,754,100,0.2700,100,0.1800,0.2160,754,0
NKSH,754,200,32.3700,100,31.8900,32.3600,754,0
DWUS,751,700,35.9700,700,35.8900,35.9100,751,0
GOAU,751,300,19.4000,800,19.2800,19.3800,751,0
IESC,751,100,49.4400,100,48.7300,49.2400,638,113
EVBN,750,100,30.3600,100,29.8900,30.2400,750,0
SLRC,748,100,18.1300,400,17.9300,18.0500,748,0
ANAT,745,100,97.4100,63,96.3800,96.7250,735,10
KKR-A,744,100,25.9300,100,25.8300,25.9200,444,300
CTAQU,742,100,10.8200,100,10.7000,10.7200,742,0
PEI-D,741,100,12.1300,100,11.8900,12.1500,645,96
SAMG,741,100,15.4500,100,15.2100,15.3100,741,0
VTAQU,739,100,10.6200,2,10.5200,10.5200,739,0
XSHD,738,300,21.1600,1100,21.1300,21.0900,738,0
AVDR,736,2268,26.2400,1000,26.1400,26.2300,736,0
PED,736,2800,1.4500,200,1.4200,1.4300,636,100
SLCT,735,100,9.7000,33,9.5700,9.5800,735,0
EFOI,734,100,5.0000,100,4.9000,4.9200,734,0
VIOV,734,19,152.9100,400,152.7800,152.7500,734,0
FHN-E,732,96,28.2300,971,28.0000,28.0000,732,0
TFC-R,732,2500,26.4500,100,26.3600,26.4100,732,0
ESXB,728,100,7.0100,200,6.9500,7.0000,528,200
XITK,728,100,227.9700,100,227.6900,227.1000,698,30
BIS,727,41,20.0400,600,20.0000,19.9800,727,0
HTD,727,200,21.1100,200,21.0800,21.0900,727,0
MEC,727,100,13.6500,100,13.1900,13.3700,727,0
BGH,725,100,15.3000,100,15.1600,15.2400,725,0
CONXW,725,100,1.9100,100,1.8200,1.8200,725,0
PROV,725,12,17.1500,112,16.9000,17.0200,725,0
DTEA,724,100,2.9400,100,2.8000,2.8600,724,0
CRAI,722,100,58.1500,3,57.7200,57.4100,722,0
SANW,721,300,3.6300,100,3.5600,3.5700,721,0
EWEB,720,100,18.0300,100,17.9100,17.9000,220,500
RJA,720,100,6.7300,100,6.6900,6.7200,720,0
UBFO,720,43,7.3100,42,7.1600,7.2100,720,0
FSI,719,100,3.6900,100,3.5800,3.5700,719,0
IFS,718,100,33.1600,100,32.5700,32.6000,240,478
NUAG,718,600,25.5800,1306,25.5600,25.5700,118,600
FSTR,717,100,15.2700,100,15.1300,15.1700,717,0
ETO,716,100,25.8700,300,25.8000,25.8800,300,416
PRFZ,716,21,164.2300,200,164.0700,164.1800,716,0
ATCX,713,100,10.1000,10,9.8900,9.9700,713,0
JBSS,713,20,79.1700,100,78.8700,78.9300,713,0
FUSN,711,100,12.9300,100,12.6600,12.9200,711,0
PNC-P,711,100,26.5700,100,26.3600,26.4700,711,0
AMEH,710,100,22.3800,100,22.2800,22.1900,710,0
CAS,710,100,10.2200,500,10.1400,10.1800,710,0
SDG,710,500,99.5200,900,99.2500,99.4200,410,300
IEDI,709,400,41.2600,400,41.2400,41.2600,709,0
PDI,709,100,26.3400,100,26.2000,26.2000,709,0
GWAC,707,100,10.2900,1000,10.2000,10.2100,707,0
NVFY,707,100,2.9600,400,2.8700,2.9550,707,0
CMCT,706,100,13.9900,100,13.7500,13.9100,706,0
MREO,706,100,3.2000,100,3.1400,3.1700,706,0
GRVY,704,100,178.1300,104,174.8000,177.7100,498,206
LNSR,704,139,6.5300,100,6.4200,6.4500,704,0
WTM,703,88,1027.2200,71,1005.0000,1010.3000,701,2
ABEQ,702,100,25.8700,3400,25.7500,25.7600,702,0
AXLA,702,100,5.7800,100,5.6900,5.7500,702,0
MGIC,702,100,17.1200,100,16.9700,17.0250,702,0
NXJ,701,200,14.3300,100,14.2600,14.3100,701,0
OLP,701,100,20.6300,100,20.3300,20.3400,701,0
QRHC,701,100,2.8700,100,2.8200,2.8500,701,0
AGNCP,700,100,24.5100,100,24.2500,24.4300,700,0
ESEA,700,100,8.0100,100,7.7500,7.9000,700,0
FMAY,700,3100,34.7900,1200,34.6300,34.7800,700,0
GEG,700,100,2.8100,1300,2.7500,2.7500,700,0
GIFI,700,300,3.8000,2,3.6700,3.8000,700,0
GNMA,700,100,51.1300,100,50.6800,50.9300,700,0
HPX+,700,100,1.4000,100,1.3400,1.4000,700,0
IG,700,100,27.1600,200,27.1300,27.1500,700,0
KNOP,700,100,17.4300,100,17.2800,17.2900,700,0
LIVK,700,100,10.3300,100,10.2100,10.2200,700,0
MMIT,700,300,26.8800,300,26.7200,26.7200,700,0
MUC,700,100,14.8900,100,14.8100,14.8700,200,500
MVF,700,1100,9.1400,900,9.1200,9.1250,500,200
NBH,700,100,15.3600,100,15.2200,15.2900,600,100
NDMO,700,300,15.5100,100,15.4100,15.5100,680,20
PHT,700,100,9.1700,100,9.0700,9.1400,700,0
PMAR,700,371,28.5900,500,28.5200,28.5600,700,0
POCT,700,1065,28.0500,500,27.9900,28.0000,700,0
PRIF-B,700,100,24.7100,100,24.5000,24.5000,700,0
SCHQ,700,100,52.6200,100,52.6100,52.6500,700,0
TOLZ,700,100,41.9400,100,41.7600,41.8050,700,0
UROV,700,400,16.1800,400,16.1700,16.1700,700,0
SRV,699,100,24.1900,243,24.0300,24.1000,599,100
STRT,698,100,45.9700,100,45.3900,45.0600,698,0
RCA,697,100,24.7800,100,24.5600,24.7400,697,0
DMS,695,100,11.3500,100,11.2300,11.2400,287,408
KTCC,695,100,7.7900,100,7.4800,7.6200,695,0
HIBL,692,100,277.9800,100,277.4800,274.7700,691,1
PICB,691,800,30.0200,100,29.8700,29.9700,391,300
CHY,687,100,14.9500,200,14.8800,14.8500,487,200
VIACA,686,100,45.6800,200,45.2100,45.4200,686,0
EDC,684,10,120.3800,100,119.7200,120.2000,559,125
LEGH,684,100,15.4600,100,15.2800,15.3400,684,0
NYMTM,684,100,23.2000,100,22.9400,23.0700,284,400
BBDO,680,300,4.1600,200,4.1300,4.1800,680,0
LTBR,680,3,5.9100,100,5.7900,5.8900,680,0
SACH,680,100,4.1800,100,4.1100,4.1500,680,0
XMHQ,680,500,71.7800,500,71.2800,71.6100,680,0
EVF,678,340,6.6400,100,6.5600,6.6100,400,278
JPIB,678,3800,51.8800,7,51.6500,51.8500,678,0
FIW,675,400,75.5400,400,75.4300,75.5000,555,120
MID,673,1000,54.9300,1000,54.8400,54.9200,673,0
ETJ,670,100,10.6700,100,10.5700,10.6100,470,200
ICL,669,100,5.4500,100,5.3900,5.4400,669,0
SYTA,666,100,10.5400,100,10.3000,10.8000,666,0
WINA,666,100,184.7700,100,180.2800,182.5900,666,0
UOCT,662,51,27.0000,7500,26.9200,26.9500,662,0
IXN,661,400,312.8800,200,312.5100,312.6200,615,46
CYAN,660,900,3.5000,100,3.3000,3.4400,560,100
NEE-Q,660,100,54.6900,32,54.5900,54.5300,660,0
UHAL,658,20,476.2700,1,474.8400,474.8400,601,57
WHG,658,100,13.0600,100,12.8100,12.9400,658,0
PSCH,655,16,184.7700,16,184.4700,184.0800,607,48
HQH,653,100,24.5600,100,24.3300,24.4850,653,0
XJR,653,9100,36.1300,8500,36.0600,36.0800,653,0
UYM,651,10,78.1600,9,77.9500,77.8400,646,5
FAAR,650,500,27.8300,100,27.6000,27.6400,650,0
FFEB,649,100,33.4500,4200,33.4200,33.4300,649,0
PZD,649,200,82.1500,100,81.7100,81.4600,649,0
HSDT,647,100,16.6700,100,16.3400,16.5000,413,234
FFHL,646,100,8.5100,100,8.2700,8.4800,626,20
VPN,645,300,16.1300,300,15.9100,15.9600,339,306
CSBR,644,100,11.5300,100,11.2600,11.3750,644,0
LARK,644,100,24.6400,100,23.7500,24.3100,644,0
NTSX,644,100,37.4000,100,37.1800,37.2650,644,0
VCTR,643,100,24.3200,100,24.0600,24.2300,643,0
BFRA,641,100,8.1700,100,8.0500,8.1000,641,0
FYX,641,400,84.8200,200,84.7500,84.7200,641,0
KRUS,640,100,23.6200,100,23.2100,23.4500,640,0
FXY,639,2600,91.1900,300,91.1700,91.1700,547,92
CBMG,637,100,18.2200,100,18.1300,18.0900,637,0
ROUS,637,100,36.3600,300,36.3400,36.3900,550,87
FBIZ,636,43,19.6800,30,19.5300,19.6200,636,0
RETL,636,100,132.6700,100,132.1400,132.0300,611,25
BCSF,631,100,12.9300,100,12.8500,12.8500,631,0
CSWC,631,45,18.6000,100,18.4700,18.5400,445,186
LKOR,629,3500,61.4000,300,61.3400,61.3100,629,0
VKQ,628,100,12.9900,100,12.8800,12.9300,528,100
URTH,627,400,115.9600,400,115.8400,115.8800,627,0
SMLF,625,100,49.6600,300,49.6200,49.5850,625,0
PAUG,623,3700,28.5300,3500,28.3900,28.4500,623,0
PGHY,623,100,22.1200,100,22.0900,22.1100,323,300
SBE=,623,200,45.7900,900,45.3200,45.3200,623,0
DUSL,622,115,29.4800,27,29.4300,29.1200,595,27
HPK,622,100,18.2800,200,18.0200,17.9900,608,14
CGW,621,400,49.0200,400,48.8300,48.9400,553,68
KOCT,621,1104,26.1700,100,26.1200,26.1500,621,0
DTF,620,200,14.4700,200,14.3500,14.3500,415,205
EAGG,620,2825,56.1000,2572,56.0700,56.0800,620,0
DGICA,619,100,14.2600,100,14.0800,14.1100,619,0
NPK,619,100,92.2200,100,91.5100,91.3300,619,0
QDEC,619,400,20.5200,4500,20.3800,20.5000,619,0
SRVR,619,4,35.9600,600,35.8800,35.9200,614,5
KUKE,618,100,9.4400,100,9.3100,9.3600,304,314
OVBC,617,100,23.6800,100,23.5100,23.5000,617,0
PHI,617,100,30.1600,100,29.9700,30.0100,440,177
DALT,615,800,10.0900,400,10.0700,10.0800,615,0
WIW,615,100,12.5300,100,12.4200,12.5300,615,0
SII,614,200,29.6600,100,29.4700,29.5300,449,165
AMH-E,612,100,25.6300,100,25.2700,25.5200,612,0
EMTL,612,500,51.1200,300,50.9600,51.0900,612,0
UJUN,612,100,28.1400,400,28.0200,28.0800,612,0
SR-A,611,600,27.9800,100,27.7300,27.9700,600,11
AJAX+,610,100,3.5200,100,3.4200,3.5100,516,94
DLS,610,1000,70.0800,400,69.8000,69.9700,610,0
GCOW,609,800,29.8900,33,29.8000,29.8600,609,0
NLY-G,609,2000,25.0000,100,24.8000,24.9300,609,0
GSIT,608,100,7.6100,500,7.5000,7.5400,608,0
IBDS,608,1000,27.5700,47,27.4900,27.4800,608,0
SFST,608,100,40.0500,100,39.2300,39.6350,583,25
QGRO,607,500,65.1200,600,65.0900,65.1200,607,0
UFPT,606,100,47.0600,100,46.7100,46.8000,606,0
MHH,605,100,16.6600,100,16.4400,16.5200,605,0
ENVIU,604,500,10.7500,100,10.6900,10.7700,604,0
EQOSW,604,100,2.4800,100,2.3100,2.3900,604,0
JDD,604,199,8.8600,500,8.8200,8.8500,103,501
CFIVU,603,100,10.8800,200,10.7600,10.8100,603,0
SCKT,603,100,2.6500,100,2.5700,2.5900,603,0
DDIV,602,400,25.7400,500,25.7100,25.7100,602,0
MQT,602,100,14.2800,100,14.1400,14.2900,602,0
RBCAA,602,100,39.1500,100,38.0300,38.0500,602,0
WPF=,602,300,13.0000,900,12.9000,12.9000,602,0
NUO,601,200,15.5700,100,15.4800,15.5700,400,201
AFIF,600,100,9.7600,5400,9.7300,9.7500,600,0
ALIN-E,600,900,22.9200,100,22.7800,22.9200,600,0
ALUS,600,100,10.4800,200,10.4000,10.4500,600,0
CMSC,600,100,27.7100,100,27.4600,27.6300,600,0
CULP,600,100,15.8200,100,15.5700,15.7650,600,0
EPS,600,5530,41.4100,400,41.3900,41.4000,600,0
EWO,600,600,21.7800,500,21.6100,21.7500,200,400
FM,600,300,29.7900,300,29.5900,29.7050,600,0
GAB-K,600,100,26.2900,100,25.9900,26.0400,203,397
HIX,600,100,6.8800,100,6.8700,6.8750,600,0
IGBH,600,300,25.0700,300,24.9000,25.0100,500,100
IMPX+,600,100,2.0200,100,1.9300,1.9400,600,0
JAGG,600,1500,27.6500,2700,27.6400,27.6200,600,0
JHAA,600,1,9.9000,2499,9.7100,9.8500,600,0
JMM,600,100,7.1000,200,7.0500,7.0800,600,0
JWS+,600,100,3.8400,100,3.7000,3.8500,600,0
LIQT,600,100,7.9700,100,7.8100,7.8100,600,0
MHI,600,100,12.4700,100,12.3900,12.3750,600,0
MIY,600,100,14.6700,100,14.5500,14.6200,600,0
MYD,600,300,14.4000,100,14.2900,14.3600,600,0
PATI,600,200,9.0900,100,8.7100,9.0200,600,0
PTA,600,100,25.3900,100,25.2500,25.2000,600,0
RJI,600,100,5.1700,10300,5.1600,5.1600,600,0
SHIPW,600,100,0.0779,100,0.0711,0.0716,600,0
SKOR,600,200,54.6600,100,54.6300,54.6200,600,0
STWOW,600,100,2.0800,100,1.9400,2.0400,500,100
TCX,600,30,79.0100,3,78.6500,79.0000,600,0
TEKK,600,100,10.5400,100,10.4100,10.4600,100,500
VUSE,600,4190,37.5400,1100,37.3300,37.4300,600,0
YSAC,600,100,10.3400,100,10.1700,10.2750,600,0
BVH,599,100,13.1700,100,12.6100,13.1700,599,0
WEBS,598,300,23.9300,33,23.8800,23.8500,0,598
DAX,591,100,31.3700,300,31.0500,31.3450,591,0
TFLO,591,2650,50.2900,9900,50.2800,50.2800,591,0
SFYX,590,2000,13.1700,100,13.1100,13.1700,590,0
IAUF,589,400,57.7800,410,57.5000,57.6700,589,0
OCN,587,200,26.6200,100,26.1800,26.3600,587,0
CHFW+,585,100,2.2000,100,1.4500,2.1600,585,0
FUSE+,583,100,3.1500,100,3.0700,3.0900,500,83
SJT,581,100,3.8000,100,3.7000,3.7700,581,0
KNTE,579,45,37.9200,100,37.7000,37.7600,579,0
NEON,579,100,9.1700,100,9.0500,9.0500,579,0
DRV,578,600,9.9800,380,9.9200,10.0900,578,0
IQI,576,100,12.9600,100,12.8400,12.9000,476,100
MLP,576,100,12.1200,100,11.6300,12.0000,576,0
BLTSU,575,100,10.5900,100,10.4900,10.5500,575,0
NUEM,575,26,37.2100,312,37.2000,37.2100,575,0
AWF,572,100,11.7700,100,11.7100,11.7200,298,274
BME,570,250,50.0200,186,49.8600,49.8600,570,0
ELAT,569,100,48.2300,200,47.7100,48.1800,569,0
CABO,568,100,2086.6600,100,2049.9100,2065.5500,466,102
OSCV,567,500,29.8000,580,29.7700,29.7900,567,0
THQ,566,764,21.0000,100,20.8700,21.0000,366,200
VSPRU,562,400,12.0600,200,12.0000,11.8800,562,0
MRCC,561,100,8.6800,100,8.6000,8.6700,200,361
MJO,560,100,115.2200,100,112.3700,112.8800,530,30
MDLX,559,100,8.0400,100,7.8600,7.9600,462,97
SCHW-D,558,100,26.0700,100,25.9200,25.8600,558,0
COF-I,557,100,26.6700,186,26.5300,26.5900,557,0
BCBP,556,100,11.9500,100,11.7700,11.7800,556,0
DRUA,556,100,26.0700,100,25.8300,25.9500,556,0
CSSE,555,8,24.4400,221,24.0600,24.2000,490,65
GBL,555,60,17.4000,11,17.3000,17.3500,555,0
BDXB,554,100,56.5400,100,56.3700,56.5500,554,0
CMU,554,1600,4.4800,100,4.4300,4.4800,554,0
LVHI,553,500,23.9200,500,23.8500,23.9000,553,0
ELDN,552,100,16.3100,100,15.9600,16.1750,552,0
IBEX,551,200,19.1900,200,18.9100,18.9900,542,9
CCBG,550,10,24.7700,100,24.3500,24.6600,550,0
MTR,550,100,4.5800,100,4.4700,4.5600,0,550
SFYF,550,2000,29.5200,2000,29.4500,29.4300,50,500
SPVU,550,200,35.9900,400,35.9000,36.0100,550,0
AIG-A,549,100,28.2100,100,27.9200,28.0500,424,125
CORR-A,549,100,20.0600,200,19.9700,20.0500,549,0
VWOB,549,100,80.8500,10,80.7600,80.8300,549,0
ACEVU,547,400,12.8100,900,12.6700,12.8050,347,200
CATH,546,100,47.4700,100,47.4200,47.4500,546,0
IVRA,545,500,12.1000,600,12.0800,12.0600,545,0
FGF,544,1,3.6900,100,3.5700,3.6000,544,0
TZOO,544,100,10.4300,100,10.2700,10.3200,544,0
DCP-C,543,100,22.3800,100,22.1500,22.3050,543,0
BHFAL,542,100,27.1300,100,26.6900,27.0000,542,0
GHY,541,100,14.6100,100,14.5700,14.5900,539,2
CID,540,500,30.8600,500,30.7200,30.8100,540,0
EDN,540,100,3.4500,100,3.3400,3.3800,540,0
STWO,538,100,10.6900,200,10.6400,10.6500,518,20
FANH,535,100,13.8900,100,13.7500,13.8600,535,0
DHS,532,300,70.4400,2350,70.4100,70.4500,429,103
LHC=,531,100,10.5100,100,10.4100,10.4800,531,0
ULBI,531,100,6.8400,68,6.7500,6.6900,531,0
IGI,530,205,21.8300,100,21.6000,21.6800,500,30
XDAT,530,100,25.6200,1000,25.4700,25.5000,530,0
ALTG,529,100,10.2200,200,10.1300,10.1500,529,0
SHBI,529,200,14.1000,100,13.9500,14.0550,529,0
TBNK,529,100,25.8400,395,25.6300,25.6600,529,0
FRX=,527,100,11.5200,300,11.4100,11.4200,427,100
VACQW,527,300,1.8300,100,1.7400,1.7400,27,500
IAE,525,100,9.5000,100,9.3900,9.4350,525,0
PSA-L,525,100,26.5800,100,26.3600,26.5400,525,0
RMT,525,100,11.1200,100,11.0100,11.0200,508,17
AMS,521,100,2.5400,200,2.4800,2.5200,521,0
NURE,521,600,27.4200,600,27.3800,27.2500,521,0
OCA=,521,100,11.2400,900,11.1100,11.1900,521,0
XELB,521,200,1.4100,900,1.3800,1.3800,301,220
GINN,520,100,59.3500,100,59.2200,58.9400,520,0
GXTG,520,100,51.4200,100,50.8600,51.1800,520,0
MFM,518,200,6.6100,100,6.5600,6.5900,318,200
ENZL,517,400,68.1400,100,67.2900,67.6800,517,0
IPAY,516,200,66.7400,400,66.6200,66.8400,500,16
LDUR,515,500,102.2400,800,102.1800,102.1600,515,0
NLY-F,514,17,25.1900,100,25.0100,25.1150,514,0
PTVCB,513,100,14.4200,100,14.3000,14.4500,513,0
BNKD,511,600,3.2100,600,3.1900,3.1900,511,0
FTC,511,500,101.1600,500,101.1000,101.1800,511,0
HRZN,511,100,13.7900,100,13.6600,13.7300,511,0
EVN,510,100,13.6600,100,13.5200,13.4600,510,0
HSRT,510,3600,41.3700,10,41.3500,41.3800,510,0
IHT,510,100,2.3800,102,2.2300,2.2700,510,0
RXL,510,110,82.7700,100,82.6800,82.3000,510,0
VOOV,509,100,127.0100,100,126.9800,126.9700,509,0
CNXT,508,200,53.8900,200,53.7000,53.7100,460,48
AQNB,507,100,28.0300,100,27.8600,28.0600,507,0
SCE-G,507,100,25.1800,100,24.7500,25.0200,507,0
NRK,506,300,13.5000,100,13.3800,13.4500,506,0
NWPX,505,200,32.2400,100,31.9700,32.1000,444,61
GASS,504,500,2.7400,100,2.7000,2.7200,504,0
LUXAU,504,100,11.8400,100,11.6400,11.8250,504,0
ERH,503,51,12.7200,100,12.7000,12.7200,501,2
NEXA,503,200,9.2000,101,8.9700,9.1100,403,100
JGH,502,100,15.3100,100,15.1400,15.2000,502,0
DDF,501,100,9.6900,100,9.5900,9.6400,300,201
RF-B,501,100,28.5300,100,28.2300,28.2500,401,100
AGNCO,500,100,25.0000,100,24.7400,24.8700,500,0
AIF,500,100,14.4600,200,14.4500,14.4500,0,500
BNSO,500,100,6.0300,100,5.6300,5.9900,500,0
BRLIW,500,100,0.9800,1700,0.9200,0.9000,500,0
BSCS,500,100,23.4000,100,23.3800,23.3500,500,0
DEH+,500,100,1.5200,100,1.4100,1.4100,500,0
DGP,500,600,42.7900,100,42.5300,42.5900,0,500
DLHC,500,100,10.3400,100,10.2600,10.3000,500,0
DZZ,500,500,2.7100,796,2.6800,2.6800,500,0
EDUT,500,100,19.2600,100,18.9700,19.1100,500,0
EOT,500,500,20.7000,200,20.6200,20.6500,500,0
FSDC,500,100,12.6400,400,12.4100,12.4600,500,0
HPF,500,219,18.6500,100,18.5700,18.5800,500,0
JHMD,500,100,32.0900,100,31.9800,32.0200,500,0
KKR-C,500,200,61.0800,200,60.5000,60.8200,500,0
LBAY,500,5000,21.3900,1200,21.3100,21.3300,500,0
LEGR,500,100,39.5400,100,39.3700,39.4600,500,0
LIXTW,500,200,1.0500,500,1.0000,1.0500,500,0
MLAC,500,100,10.1900,100,10.0900,10.1700,100,400
MTACU,500,200,10.7400,1,10.5700,10.5800,200,300
OFS,500,100,6.9800,100,6.9100,6.9500,500,0
OLB,500,100,5.4600,100,5.2200,5.2600,500,0
PAK,500,100,30.2800,100,29.9700,29.9700,500,0
PALL,500,500,222.1600,592,221.0000,222.3300,500,0
PIE,500,1300,24.7300,100,24.6300,24.6900,500,0
PKO,500,100,24.9400,100,24.7000,24.8100,500,0
PRT,500,100,3.1600,100,3.0100,3.1800,500,0
PSFD,500,3000,21.3200,3000,21.2000,21.2100,500,0
QED,500,500,23.9400,500,23.9100,23.9200,500,0
QELLW,500,100,3.7800,100,3.6900,3.6800,500,0
RHS,500,200,149.0100,200,148.9600,149.1000,500,0
RILYZ,500,100,25.1900,100,24.9700,25.0600,500,0
TWND=,500,200,11.4300,1000,11.2900,11.3600,500,0
IRMD,499,42,23.3500,100,22.6500,23.4200,497,2
STRM,499,300,1.6900,4,1.6500,1.6600,100,399
AGNCN,497,100,25.7800,100,25.4100,25.6300,497,0
ELMD,497,100,10.0700,100,9.9800,9.9900,497,0
MXC,497,100,7.7600,100,7.5800,7.5400,351,146
CRHC+,494,100,2.0800,100,2.0000,2.0000,100,394
KMED,494,100,37.0100,100,36.3700,36.4600,494,0
SWT,494,100,111.6400,100,110.9000,111.0900,479,15
TPGY=,492,400,27.2100,500,27.0900,27.5400,492,0
PAPR,491,1949,27.4000,7400,27.3500,27.3700,491,0
QQQN,491,1000,33.7200,1000,33.6800,33.7800,491,0
TGS,491,100,5.2600,100,5.1400,5.2400,491,0
FCAP,488,100,56.9200,100,54.9000,56.0000,488,0
HNW,488,100,14.5600,100,14.4400,14.5000,255,233
PBE,486,900,75.7400,700,75.5500,75.9100,304,182
VFMF,486,1500,89.8400,1800,89.7200,89.5800,486,0
EBLU,485,100,41.7700,100,41.2900,41.4400,400,85
HEEM,485,100,33.6700,62,33.6400,33.6600,485,0
TSBK,484,19,27.7500,100,27.3000,27.6300,484,0
CCF,481,100,105.5600,100,104.2000,104.7500,481,0
DSTL,480,800,37.5600,500,37.5400,37.4700,480,0
GS-K,480,100,29.4000,100,29.0900,29.2900,80,400
PEB-C,480,100,23.6100,100,23.3600,23.4000,480,0
ATLO,479,15,24.1100,15,23.8600,23.9000,479,0
FNY,479,300,70.6900,248,70.6100,70.6800,479,0
UZA,478,100,25.5100,100,25.3100,25.4400,287,191
PKW,477,1000,77.6200,2800,77.5800,77.5800,477,0
JMOM,474,100,40.5400,100,40.1600,40.3500,474,0
BKN,472,239,17.2200,100,16.9000,17.1200,472,0
CLWT,472,100,4.2600,100,4.0800,4.1500,472,0
FOCT,472,400,32.0400,200,31.8700,31.9300,472,0
XNTK,472,100,152.1800,100,152.1000,151.6600,472,0
ZNH,471,100,28.4200,100,28.3100,28.4300,471,0
TARA,469,100,19.5400,105,19.2500,19.4300,418,51
CSPI,468,100,12.0900,100,11.6600,11.8400,468,0
SMMF,466,100,22.2100,100,21.8400,22.0600,466,0
ESGRP,465,200,30.3400,100,28.4700,28.8500,465,0
CHCI,461,500,3.4800,500,3.3300,3.3400,361,100
FT,461,600,7.4700,700,7.4000,7.4600,0,461
IPAC,461,100,66.5100,300,66.4100,66.4100,461,0
PDN,461,100,35.8900,1100,35.6700,35.7700,461,0
TIGO,461,100,40.3900,29,40.1200,40.2000,461,0
RMBL,460,100,33.1200,100,31.9900,32.4900,150,310
MUA,459,100,15.3000,100,15.1200,15.2400,459,0
IXG,458,500,67.9600,500,67.4500,67.6500,448,10
MTT,456,200,21.3100,100,21.1700,21.2500,456,0
NOA,456,100,10.2900,100,10.2400,10.2100,456,0
PPA,454,600,68.2900,1300,68.2500,68.2900,181,273
JQUA,453,400,36.6400,5950,36.6200,36.6150,448,5
CBON,452,200,24.1800,100,24.1600,24.1650,452,0
FDEU,450,1100,12.1700,500,12.1200,12.1400,450,0
MOTI,450,300,34.7800,637,34.6500,34.6700,450,0
WLFC,449,100,32.7200,100,32.0800,32.9000,449,0
NL,448,100,4.6800,100,4.6100,4.6600,448,0
CRBN,447,200,154.7100,200,154.3600,154.6700,447,0
PSJ,447,100,165.6700,20,165.5900,165.4450,418,29
DPG,446,100,13.0600,100,12.9400,13.0000,446,0
MS-K,446,100,29.0700,100,28.6600,28.9400,446,0
TWND+,445,100,1.9700,100,1.8300,2.1000,345,100
IX,444,100,85.2800,200,84.5400,85.0500,444,0
RICE,444,200,11.5700,200,11.4900,11.5600,430,14
TLC,444,100,4.9500,200,4.7700,4.7800,444,0
XAR,444,200,119.1200,200,118.9700,119.0500,210,234
DFND,441,4000,36.9500,500,36.6200,36.9400,441,0
TC,441,100,3.9300,100,3.8200,3.8800,441,0
DLR-J,440,100,26.5500,200,26.3700,26.3700,440,0
HYHG,440,100,62.8600,100,62.4800,62.7700,440,0
EDI,439,100,9.0100,100,8.8900,9.0050,439,0
DDLS,438,600,31.7500,69,31.7000,31.7000,238,200
LMST,438,21,13.4500,100,13.2000,13.3000,438,0
FUNC,437,100,16.2300,100,15.9400,16.0000,437,0
GDP,437,100,10.6200,100,10.4500,10.5400,437,0
SCM,437,100,11.5000,101,11.4300,11.3500,437,0
VJET,437,100,16.7300,100,16.5300,16.3800,286,151
IKT,434,100,6.5800,100,6.5400,6.5200,434,0
TTAC,433,1200,47.8100,1200,47.7300,48.0800,433,0
UBOT,433,13,46.8200,13,46.5100,46.7300,292,141
GDXU,432,100,22.8500,300,22.6500,23.0000,432,0
ACU,431,100,31.9700,110,31.0000,31.0500,431,0
KBA,431,1000,49.4400,300,49.3200,49.2900,431,0
BCYPU,430,67,10.4000,100,10.3800,10.4000,430,0
ICOW,430,500,30.2900,500,30.1900,30.1400,430,0
LIVKW,430,100,1.0100,200,0.8800,0.9550,315,115
PZC,430,300,10.4000,200,10.3500,10.3500,130,300
TPL,428,18,819.5000,10,810.0700,819.5000,428,0
JPM-H,427,100,25.8200,100,25.5800,25.7200,427,0
VLGEA,426,36,22.1700,100,22.0600,22.0300,426,0
HMTV,425,100,10.4200,100,10.2900,10.4200,425,0
UAN,425,100,15.6000,100,15.4200,15.5000,215,210
VBND,425,100,52.0600,100,51.5600,51.8300,400,25
FTIVW,422,199,2.1800,100,2.0600,2.0800,400,22
TBB,422,100,26.8400,400,26.6700,26.8000,322,100
LEAD,421,400,48.6400,500,48.6100,48.5900,421,0
IVAL,420,500,28.2000,300,28.1200,28.1300,420,0
KFVG,420,100,29.9200,100,29.6100,29.7500,400,20
OCAXU,420,100,10.4400,100,10.3700,10.3900,400,20
SSUS,420,1500,30.0700,1300,29.9900,30.0200,420,0
HBCP,418,100,29.5100,100,29.0900,29.3900,418,0
SGA,418,100,21.9300,5000,21.0000,21.7700,416,2
REW,417,259,13.1800,59,13.1500,13.2500,299,118
GAM,416,14,38.3600,100,38.1400,38.2300,416,0
INDS,416,15,36.7600,15,36.6700,36.7300,416,0
TPGY+,416,100,8.7300,100,8.6200,8.6500,234,182
MCBC,413,200,8.8500,100,8.7700,8.7850,413,0
FLIA,412,1,25.3800,8100,25.3400,25.3800,412,0
BFIN,410,200,9.0100,100,8.8800,8.9600,410,0
VMACW,410,100,1.0700,100,0.9800,1.1000,200,210
ELA,408,300,5.4400,300,5.3100,5.4200,408,0
BLCN,407,100,42.2300,100,42.0700,42.1600,407,0
BPRN,407,9,23.7100,9,23.3100,23.2900,407,0
ESSA,407,114,15.5000,100,14.9600,15.0300,407,0
PHX,406,100,3.1400,100,3.0200,3.0800,206,200
STOT,406,800,50.0300,4300,49.9400,50.0200,406,0
ATH-B,405,100,26.7400,100,26.4100,26.5750,405,0
BXMX,405,300,12.7000,200,12.6500,12.7000,405,0
ESGA,405,1000,48.6100,1000,48.5300,48.5700,405,0
BBF,404,200,13.5300,100,13.4600,13.4900,200,204
CEFA,403,4400,31.0600,500,30.9200,30.9800,403,0
TCFC,403,109,26.9100,100,26.6500,26.7600,403,0
VIRS,403,500,29.5300,500,29.5100,29.4400,403,0
AESR,402,800,12.2300,401,12.2000,12.1900,402,0
GLMD,402,500,3.7900,100,3.6900,3.7400,402,0
NUZE,402,100,9.9900,100,9.5200,9.5600,402,0
AACG,401,2,1.4200,26,1.3900,1.4000,301,100
BLW,401,100,16.1800,100,16.0800,16.1800,401,0
NM,401,300,3.4900,300,3.3700,3.4500,401,0
SRSA,401,100,10.4500,100,10.3200,10.3600,401,0
AGBAW,400,200,0.5600,200,0.5100,0.5001,300,100
AGCWW,400,100,6.8400,100,6.5700,6.0900,400,0
AXR,400,100,8.0700,100,7.8700,7.8500,400,0
BSL,400,400,14.8100,100,14.7000,14.7900,400,0
CCAC+,400,100,2.0000,100,1.9500,2.0000,400,0
CCNEP,400,500,26.4500,100,26.1500,26.2000,400,0
DCRBW,400,100,3.2400,100,3.0200,3.2000,400,0
DTB,400,100,25.4400,100,25.1400,25.2100,100,300
EDF,400,100,8.1200,100,8.0400,8.0800,400,0
EEMO,400,200,21.3900,200,21.2900,21.3800,400,0
EQAL,400,600,40.6600,800,40.6300,40.6400,400,0
GIX+,400,100,1.6800,100,1.5700,1.5700,400,0
GSAH+,400,100,3.7500,100,3.6500,3.6800,300,100
IIM,400,200,15.5900,100,15.5200,15.5600,300,100
IMTXW,400,100,3.0300,100,2.6800,2.8000,400,0
INM,400,100,4.1900,100,4.1300,4.1400,400,0
JJC,400,100,55.6300,100,55.0200,55.1100,0,400
LCAPU,400,100,11.0900,100,10.9600,11.0000,100,300
LGI,400,100,18.8100,100,18.6200,18.7150,400,0
MDIA,400,300,3.1300,100,2.9700,3.0600,400,0
NBB,400,100,23.9600,100,23.7100,23.8900,100,300
NIFE,400,700,68.6900,700,68.5600,69.0300,400,0
OACB=,400,100,11.4400,100,11.2800,11.6500,0,400
PRPB+,400,100,2.2700,100,2.2000,2.2100,300,100
PSF,400,100,26.9900,100,26.7500,27.0300,400,0
RDCM,400,100,10.7100,100,10.5200,10.5000,400,0
RILYG,400,100,25.3400,100,25.1100,25.2200,400,0
ROMO,400,100,26.1400,100,26.0800,26.0800,400,0
RORO,400,5000,22.8100,5200,22.7100,22.7900,400,0
RYU,400,200,99.5600,200,99.5200,99.2700,400,0
SPEU,400,100,38.9000,100,38.7400,38.7700,400,0
TNP-F,400,100,22.7800,100,22.5600,22.7000,400,0
UCBIO,400,100,27.6100,100,27.4500,27.4500,400,0
VCVCW,400,100,2.2700,100,2.1500,2.2000,200,200
VRMEW,400,100,1.2100,100,1.0700,1.0700,400,0
WDIV,400,300,62.9500,100,62.7600,62.8600,400,0
WTFCM,400,46,27.7900,100,27.6500,27.6500,400,0
YCBD-A,400,100,8.1600,100,7.9100,7.9500,400,0
PBLA,399,100,4.1500,100,4.0100,4.1500,399,0
KIM-M,398,100,26.1500,100,25.8000,25.9600,398,0
NUSI,398,100,27.7500,100,27.7200,27.7000,398,0
FITBO,397,100,26.5300,100,26.1800,26.3800,397,0
LRGE,397,2000,50.8800,2000,50.6100,50.6900,397,0
CEA,396,200,20.8700,200,20.6700,20.7700,396,0
VTHR,396,100,180.1400,100,180.0400,179.5600,396,0
NS-A,394,100,20.4700,100,20.2800,20.5100,394,0
ALIN-B,393,100,23.1300,100,22.9100,22.9000,200,193
MET-A,393,100,25.5300,300,25.3000,25.4000,393,0
PANL,393,100,2.8200,200,2.7100,2.7600,393,0
TWO-B,393,100,23.7500,100,23.5100,23.6800,14,379
RWJ,392,33,92.2900,33,92.1300,92.2200,292,100
UAUG,392,300,27.9600,4000,27.9400,27.9600,392,0
ITAC,391,100,10.3300,100,10.2500,10.3000,391,0
SFBC,389,100,32.3700,500,32.0000,32.2500,389,0
GS-A,386,100,24.4400,100,24.2000,24.2800,386,0
KEY-J,386,100,27.0200,100,26.6600,26.8800,386,0
ORRF,384,100,17.9500,100,17.7800,17.8800,384,0
CIVB,383,100,18.2900,149,18.2200,18.3000,383,0
MVBF,383,13,23.0100,8,22.7400,22.9000,383,0
GFLU,382,100,73.3100,200,73.0800,73.3500,382,0
VSTA,381,100,14.1800,100,13.9700,14.0700,381,0
C-K,380,100,28.4700,100,28.2000,28.3900,380,0
HYDB,377,300,51.5000,20,51.4600,51.4700,377,0
GEF.B,376,100,50.8800,100,50.0600,50.6500,376,0
GPP,376,100,9.7400,100,9.5400,9.6300,376,0
CSM,374,100,88.1500,2000,88.0300,88.0850,374,0
FNWB,372,100,16.2600,100,16.0800,16.2600,372,0
WWJD,371,100,32.3700,100,32.0800,32.2000,371,0
PFEB,370,4400,26.4800,133,26.4100,26.4600,370,0
BSET,365,5,21.4600,100,21.1800,21.3550,365,0
EWZS,365,100,16.0600,600,15.9900,15.9400,365,0
FLTB,365,1200,52.8400,300,52.8000,52.8050,0,365
IGEB,363,186,54.7100,3900,54.6700,54.6600,363,0
CRSAW,362,100,1.9800,100,1.8600,1.9400,300,62
KTF,362,150,11.5600,100,11.5000,11.6000,100,262
CALB,361,100,13.9400,100,13.7600,13.8100,361,0
DURA,361,200,28.6900,200,28.6800,28.7100,361,0
ARGD,360,100,25.7800,100,25.4800,25.6900,360,0
XSW,360,100,159.6500,300,159.4800,159.7000,360,0
BSCT,359,1600,21.5500,100,21.5300,21.5200,359,0
MFA-B,359,100,23.8800,100,23.6300,23.7100,100,259
TSI,359,100,5.6100,101,5.5600,5.6500,359,0
FNGO,357,200,209.1200,200,208.8700,208.7000,357,0
IMBI,354,100,5.4200,300,5.2600,5.3600,353,1
AJXA,353,100,25.0400,100,24.5200,24.8700,353,0
NS-C,352,100,21.7900,100,21.5000,21.7600,352,0
MRAD,350,500,27.7900,500,27.7500,27.8000,350,0
PFO,350,100,12.9300,100,12.6600,12.7800,350,0
SECT,350,2500,37.0900,65,37.0300,37.0500,350,0
WINT,350,2,5.7100,100,5.6400,5.6000,350,0
ZEUS,350,9,15.6100,100,15.4400,15.5000,350,0
ARTNA,349,80,37.7400,100,37.4500,37.7400,349,0
BTRSW,349,100,5.3400,100,5.2500,5.4300,349,0
COE,349,100,25.4000,100,24.9300,25.1700,349,0
GNAF,349,2100,15.5300,3351,15.5000,15.5100,349,0
UTF,349,100,27.1400,100,26.9000,27.0350,349,0
SBFG,348,8,17.1900,100,16.9900,17.0000,348,0
QUS,347,100,106.6100,1500,106.5600,106.5200,305,42
IEAWW,346,100,5.8300,100,5.7400,5.7200,200,146
PMT-B,346,100,24.7200,100,24.3300,24.5800,346,0
CGA,345,100,5.9100,100,5.7700,5.8000,245,100
NETL,344,100,25.6600,100,25.4300,25.4000,344,0
BLNKW,343,100,41.8600,100,41.2700,41.4000,100,243
USB-P,343,100,27.7300,100,27.4000,27.5100,25,318
BFC,341,113,69.7000,100,68.5900,69.6100,341,0
FVAM,340,100,10.6500,100,10.4000,10.5600,0,340
CATC,339,100,76.9900,100,75.2000,76.2000,339,0
RVT,339,100,17.4800,100,17.3300,17.3900,339,0
FNLC,338,100,25.8200,100,25.5700,26.0000,329,9
ALFA,335,600,82.5000,1200,82.3800,82.3900,335,0
FRX+,333,100,2.7500,100,2.5600,2.6900,233,100
ECF,332,100,14.8900,100,14.7000,14.7400,132,200
RUSL,332,2400,23.6800,32,23.6100,23.7000,332,0
GWX,331,400,36.6300,600,36.2900,36.2600,331,0
AEYE,329,100,25.0800,100,24.5300,24.8050,197,132
FSBW,329,214,56.5300,14,55.7100,56.3000,329,0
ANDAR,326,13,0.4100,100,0.3200,0.4100,326,0
FCBP,326,125,19.4800,100,19.3100,19.3900,313,13
AVNW,325,100,37.8900,100,37.4400,37.5400,305,20
AVDE,323,100,59.3300,200,58.9400,58.9700,323,0
ACGLP,321,100,25.6500,200,25.4000,25.5400,321,0
BLDG,321,1000,29.6500,1084,29.4300,29.5300,321,0
KEY-I,321,100,28.8100,100,28.5200,28.7000,321,0
CNBKA,320,100,84.7900,100,82.0800,83.8000,320,0
CO,320,100,3.9300,400,3.8800,3.9100,320,0
FFTG,320,300,29.3100,300,29.2200,29.2300,320,0
VIOG,320,100,214.9600,100,214.6600,214.2900,320,0
UZE,319,100,25.2300,100,25.0000,25.1200,319,0
AFGB,318,100,27.5500,100,27.2500,27.3200,318,0
VALU,317,100,30.6200,100,28.9900,30.2000,317,0
BBW,316,100,4.5700,141,4.5300,4.5300,316,0
ODC,316,100,33.9100,100,33.5500,33.3700,316,0
FMN,313,100,14.6400,100,14.4800,14.5600,313,0
IHAK,313,400,42.1500,460,41.9800,42.0600,113,200
BSBK,312,100,9.0700,100,8.7800,8.9500,312,0
KAPR,311,400,27.0200,200,26.8700,26.9600,311,0
CLGN,310,120,14.5000,1000,14.2500,14.3200,310,0
PLAG,310,100,2.7500,100,2.6500,2.7050,310,0
DWAW,309,200,39.8200,100,39.6300,39.6700,309,0
FIBR,308,2300,102.2600,300,102.0800,102.2300,308,0
HZN,308,100,9.0600,71,9.0100,9.0400,308,0
EOS,307,100,21.8300,100,21.6500,21.7600,307,0
HCAR,307,100,10.2000,142,10.1500,10.1900,307,0
USAU,307,100,13.2000,100,12.9000,12.9100,307,0
FNCB,306,100,6.2400,100,6.1200,6.1900,306,0
QLC,306,300,42.4500,300,42.4100,42.3900,306,0
BIF,305,100,11.3400,100,11.2300,11.2700,305,0
PDLB,305,100,9.9800,100,9.8700,9.8100,305,0
CLII+,304,100,3.2100,100,2.1900,3.1900,105,199
FWP,304,100,6.6000,600,6.5000,6.5450,304,0
QVCC,304,100,25.4400,100,25.1100,25.2500,300,4
FLXS,303,100,34.4400,100,33.9400,34.0000,303,0
FPH,303,500,6.5300,400,6.4500,6.5500,303,0
PJUN,303,47,30.2600,2200,30.2100,30.2200,303,0
FLNG,302,100,9.5400,100,9.4200,9.5500,301,1
GRID,302,200,86.5000,200,86.1900,86.3900,302,0
NCBS,302,100,72.6800,100,71.7800,72.3300,302,0
PFFA,302,500,22.3200,500,22.2500,22.2900,100,202
RENN,302,100,6.1000,100,5.9700,6.0550,302,0
RIGS,302,200,24.8200,1000,24.6400,24.6800,302,0
USMF,302,400,36.8100,1100,36.7900,36.8100,302,0
FFHG,301,300,31.7500,300,31.6300,31.7400,301,0
INTF,301,1200,28.1300,1100,28.0300,28.0300,300,1
PLW,301,100,37.5700,100,37.3600,37.5800,101,200
PSFF,301,3000,20.7500,3000,20.6000,20.7300,301,0
RHE-A,301,100,2.7100,200,2.4600,2.7000,301,0
WBIL,301,100,28.4400,100,27.2700,28.3700,300,1
WEYS,301,100,16.9800,400,16.8800,16.8600,301,0
AFINO,300,100,25.1000,100,24.8600,25.0000,300,0
AHL-E,300,100,26.2500,100,25.9100,26.0400,300,0
AIZP,300,100,130.8100,100,130.5700,130.6900,300,0
ALIN-A,300,100,21.5800,100,21.2600,21.7200,300,0
AONE+,300,100,2.4100,100,2.2100,2.2200,300,0
ASEA,300,200,15.1100,200,15.0000,14.9900,300,0
ATAC=,300,500,11.6200,400,11.5700,11.5400,300,0
BBH,300,100,186.0300,500,185.9000,185.4700,300,0
BTEC,300,1100,64.1600,1100,63.9700,64.1000,300,0
BYM,300,100,15.2300,100,15.0500,15.1700,300,0
CRD.B,300,100,8.0300,300,7.9500,7.9500,300,0
DBL,300,100,19.9300,100,19.7600,19.8650,300,0
DCUE,300,100,97.0300,100,96.9500,97.0200,300,0
DJP,300,200,22.6100,200,22.6000,22.6000,300,0
DMYI+,300,150,2.9400,100,2.8600,2.8500,300,0
ECOZ,300,200,36.2600,300,36.2300,36.2200,300,0
ENPC,300,200,25.9400,100,25.6500,25.9000,300,0
EPSN,300,100,3.9500,100,3.7400,3.8600,100,200
EQD+,300,100,1.8800,400,1.8300,1.9000,300,0
EURZ,300,1000,24.9100,1000,24.8800,24.8800,300,0
EVY,300,200,14.8200,200,13.2600,13.9100,300,0
EYEG,300,100,6.4700,100,6.3300,6.4000,300,0
FCA,300,200,30.4400,400,30.2700,30.5500,300,0
FCCY,300,100,15.5200,16,15.3600,15.4900,300,0
FCNCP,300,100,26.5300,100,26.2500,26.3900,300,0
FINS,300,100,17.4600,500,17.2400,17.3400,300,0
FNX,300,300,89.0000,200,88.9300,88.8800,300,0
GFNSZ,300,100,26.0000,100,25.8400,26.0400,300,0
HEWU,300,300,21.5100,300,21.4500,21.4500,300,0
HPX,300,100,10.5500,100,10.4100,10.4000,300,0
HYI,300,100,15.4500,100,15.2900,15.3800,300,0
ICCC,300,100,7.2000,100,6.9600,7.0500,300,0
ICMB,300,11,5.1000,100,5.0100,5.1000,300,0
IDOG,300,100,27.1600,200,26.9300,27.0400,300,0
IGN,300,300,65.4800,300,65.4300,65.2800,300,0
IMOS,300,100,26.5100,100,26.3100,26.3000,300,0
ITCB,300,200,5.6000,100,5.4200,5.5800,300,0
JIG,300,100,77.7100,100,77.5800,77.6500,300,0
JPSE,300,700,39.5100,200,39.3800,39.5000,300,0
JTD,300,200,14.4400,100,14.3400,14.3800,300,0
JWS=,300,100,17.4800,100,16.0300,16.8800,300,0
KEY-K,300,100,27.6900,100,27.3400,27.5900,300,0
LANDO,300,100,25.4000,100,25.1600,25.3200,300,0
LSAF,300,1600,29.7300,1500,29.6000,29.7500,0,300
LVHD,300,200,32.8500,3400,32.8400,32.8600,300,0
MAACW,300,100,1.5900,100,1.4800,1.5400,300,0
MARPS,300,4,3.9400,100,3.8400,3.9200,300,0
MFD,300,100,8.7600,100,8.6600,8.7100,300,0
MKGI,300,1700,2.3200,100,2.2500,2.2900,300,0
MS-L,300,100,26.3800,100,26.1500,26.3600,300,0
MSB,300,100,28.4000,100,28.2400,28.2500,100,200
NAN,300,100,14.3200,100,14.1600,14.2600,300,0
NCA,300,100,10.9900,100,10.8700,10.9600,300,0
NEPH,300,100,8.0300,100,7.7200,7.8800,300,0
NMS,300,100,14.9000,100,14.7900,14.9050,300,0
NSH+,300,100,1.8000,100,1.7400,1.7900,300,0
OCA+,300,200,1.9000,100,1.8200,1.8500,300,0
OIL,300,2000,15.3200,200,15.2900,15.2800,300,0
OPINL,300,100,26.4800,100,26.1400,26.4000,300,0
OXBRW,300,100,0.1606,100,0.1379,0.1500,300,0
PBND,300,300,26.4500,401,26.4000,26.4500,300,0
PBP,300,500,20.9000,200,20.7600,20.8500,300,0
PCK,300,204,9.0600,100,9.0200,9.0200,200,100
PMM,300,100,8.1100,100,8.0300,7.9600,300,0
PSTH+,300,100,10.6400,100,10.4500,10.5100,300,0
RAVI,300,1500,76.3300,2500,76.2500,76.3100,200,100
SHYL,300,300,47.7200,300,47.6200,47.6900,300,0
SRTS,300,100,3.8600,100,3.7300,3.8600,300,0
TESS,300,100,7.3700,800,7.2000,7.0500,300,0
TSQ,300,100,7.7400,200,7.5700,7.6900,300,0
UMAR,300,300,27.8800,300,27.7900,27.7900,300,0
UNOV,300,300,28.3900,200,28.3200,28.4100,300,0
VACQ,300,100,10.5000,100,10.4600,10.4900,300,0
VER-F,300,100,25.4800,100,25.2800,25.3600,100,200
VERBW,300,200,0.5888,200,0.3276,0.4500,300,0
WBND,300,200,28.0100,200,27.9700,27.9800,200,100
WRB-D,300,100,25.7000,100,25.4800,25.5800,200,100
YSACW,300,300,1.5400,100,1.3500,1.3600,300,0
BLUWU,299,100,10.7200,200,10.6600,10.6600,299,0
AMUB,298,2200,9.6000,1100,9.5400,9.7000,200,98
EOI,298,200,16.7900,100,16.6700,16.7400,298,0
HSON,298,100,13.0500,100,12.9400,14.1000,298,0
LYRA,298,100,11.7700,100,11.4900,11.7900,298,0
GLTR,296,2400,97.1900,2000,97.0700,96.8600,296,0
NGHCO,296,4500,25.0900,100,24.9800,25.0800,296,0
PETZ,295,100,2.0800,100,2.0000,2.0300,195,100
AE,294,100,26.2200,100,25.0000,25.2000,294,0
RMCF,293,100,4.7400,1,4.6900,4.7000,293,0
SLT,293,600,38.6100,800,38.5800,38.5900,293,0
BYLD,292,100,25.6500,400,25.6100,25.6300,292,0
DTP,292,100,47.2400,200,47.1700,47.2700,285,7
GMLPP,292,100,24.6500,100,24.3100,24.5500,292,0
REK,292,600,11.3400,571,11.3200,11.3700,221,71
BSVN,290,100,15.4600,200,14.9600,15.1900,290,0
APTV-A,289,100,166.9200,100,166.6000,166.5200,289,0
CRAK,288,100,27.1500,600,26.9000,26.9850,288,0
HGH,288,34,27.5600,100,27.4200,27.5700,188,100
FRPH,287,100,46.5800,100,46.0700,46.4000,257,30
ARR-C,286,100,24.7900,100,24.5700,24.6500,286,0
LEO,285,100,8.3800,500,8.3300,8.3500,285,0
SNUG,285,100,28.3700,100,28.0900,28.2200,285,0
ARDS,284,100,7.2600,100,6.9600,7.2200,284,0
IEME,284,500,35.2400,500,35.2000,35.2200,284,0
RUSHB,284,100,42.0000,100,41.4900,41.7600,284,0
PBCTP,283,100,28.3200,100,27.5900,27.9500,283,0
GII,282,400,50.7200,687,50.5600,50.6000,274,8
AL-A,281,100,25.6600,100,25.3600,25.5300,150,131
WFC-X,281,100,26.0600,100,25.8200,26.0100,281,0
DEMZ,280,700,23.5200,700,23.4700,23.4900,280,0
NUHY,280,200,25.0400,100,24.9700,25.0100,280,0
ASHS,279,400,37.3700,300,36.9900,37.1500,159,120
HPI,279,325,18.8900,100,18.8100,18.9300,279,0
ATTO,277,100,17.4100,100,16.9600,17.4200,277,0
WTRU,276,200,58.9200,200,58.8300,58.8600,276,0
XGN,276,100,16.4600,100,15.9000,16.2200,176,100
PFIS,275,100,39.1500,4,39.0100,39.0100,275,0
UUUU+,275,200,2.1700,200,1.1900,1.6500,0,275
BNY,272,100,14.5800,100,14.4000,14.5200,272,0
DX-C,272,100,25.0800,100,24.7900,24.9400,272,0
BH,269,10,111.9400,30,110.5600,111.0250,229,40
JSM,269,57,24.8500,100,24.4800,24.7200,269,0
GNL-B,268,100,25.2900,100,25.0300,25.1500,268,0
STND,268,97,32.8200,100,32.7600,32.8200,268,0
RGCO,267,100,23.8900,95,23.7100,23.7100,267,0
IMTE,266,42,4.1600,100,4.0700,4.1200,266,0
IYK,265,100,178.7200,100,178.6600,178.9100,265,0
RZA,265,100,27.3800,100,27.0200,27.3400,265,0
RICE=,264,100,12.9800,900,12.8200,12.7200,64,200
RYT,263,100,262.2200,100,262.1200,261.0400,263,0
DWAS,262,40,83.9500,200,83.8800,83.8100,262,0
EGLE,262,100,22.4300,100,22.2000,22.1800,262,0
LWAY,262,202,6.1400,100,6.0000,6.0600,262,0
RWL,261,300,64.9900,300,64.9600,64.9900,261,0
TCTL,261,300,30.7600,700,30.6800,30.6700,261,0
AWX,260,100,3.0600,105,2.9400,2.9700,203,57
BNDW,260,100,81.5900,200,81.5600,81.6000,260,0
JSD,258,26,13.6500,100,13.5800,13.6300,258,0
ALJJ,256,200,1.3600,500,1.3300,1.3500,256,0
CHSCL,255,100,29.5000,100,29.1600,29.3500,255,0
SIF,252,100,10.1800,100,9.9300,9.9500,201,51
MYFW,251,100,19.8700,100,19.6400,19.7000,251,0
HYDW,250,300,50.8500,300,50.7900,50.8600,250,0
PTSI,250,100,60.2100,100,58.2700,58.0000,150,100
PDEC,249,500,29.3000,1000,29.1800,29.2500,249,0
VALQ,249,500,44.0900,600,44.0300,44.0600,249,0
NXTG,248,1200,74.2700,1300,73.7800,74.0600,113,135
IVR-C,245,100,24.1400,100,23.9100,24.0400,245,0
TPHD,243,300,26.8200,200,26.6300,26.7200,243,0
EYLD,242,81,36.3000,2,36.1800,36.3000,242,0
CMPI,241,100,14.2400,100,13.6800,13.7200,241,0
VTA,241,1204,11.0500,100,11.0400,11.0400,241,0
AVTR-A,240,100,96.6200,100,96.4700,96.4700,200,40
WSTG,240,100,19.3000,100,18.5700,18.9100,190,50
MSTB,239,1100,27.8500,500,27.7700,27.8500,39,200
MVO,238,100,3.7600,100,3.6700,3.7600,238,0
UTMD,238,100,87.9200,100,85.9100,86.7400,238,0
ASYS,237,100,7.5900,70,7.5000,7.5600,237,0
IXP,237,900,77.7500,900,77.4000,77.5800,237,0
RNDB,237,9,20.1500,9,19.7500,20.0000,237,0
BOB,236,525,25.1200,400,25.0900,25.0600,236,0
CII,236,600,18.0500,500,17.8900,17.9800,236,0
GRF,235,200,8.0000,200,7.9300,7.9500,235,0
BENEU,234,100,10.6900,100,10.5600,10.6000,224,10
MMAC,233,100,24.2300,5,24.1100,24.1000,233,0
PBI-B,233,100,23.4900,100,23.2600,23.4500,233,0
QYLG,233,400,30.6700,100,30.6000,30.6300,233,0
NNN-F,232,100,25.8200,100,25.4800,25.5400,232,0
IVR-B,230,100,23.8200,100,23.5200,23.7800,230,0
KEP,230,600,11.2700,100,11.2000,11.2200,230,0
SSPKU,230,313,30.0000,801,29.5100,28.2000,200,30
TEQI,230,2500,30.7100,2500,30.6700,30.6600,230,0
CFR-B,229,100,25.7200,100,25.3800,25.4800,229,0
FLJP,229,800,30.4200,400,30.2900,30.4000,229,0
GSSC,227,400,59.3300,100,59.0300,58.7000,209,18
LOUP,227,100,57.2400,100,57.1100,57.2200,227,0
TRNS,226,5,36.8300,100,35.9800,36.6400,226,0
ACWF,225,1000,35.6500,1000,35.5100,35.6100,0,225
ATCO-G,225,100,25.8100,100,25.5100,25.7300,225,0
BOAC+,224,288,2.5500,100,2.4100,2.4600,224,0
GCC,224,1100,19.5000,100,19.4700,19.4900,224,0
SPFI,224,100,19.8200,100,19.6300,19.6600,224,0
EDUC,223,100,14.7900,100,14.4400,14.5550,223,0
PANA=,223,400,12.2400,900,12.0600,12.2200,223,0
PSA-D,223,100,25.7800,100,25.4500,25.6500,137,86
BAMI,222,100,25.0800,100,24.8800,25.0000,100,122
FSFG,222,100,61.9900,100,61.0600,61.0000,222,0
AAME,221,41,2.4700,200,2.3400,2.4000,127,94
MDCA,221,700,2.6500,600,2.5700,2.6000,221,0
RFFC,221,200,40.5600,300,40.3300,40.4600,221,0
SCE-J,221,300,24.2300,100,24.2000,24.2400,221,0
AVK,220,81,16.9600,100,16.8800,16.9600,220,0
NSYS,219,100,7.7400,100,7.4900,7.7000,119,100
HQL,217,100,20.8500,100,20.6200,20.7200,217,0
ALX,215,100,279.4100,62,274.5100,276.7000,215,0
IAK,215,600,69.6200,600,69.5100,70.1700,215,0
TEI,215,16,7.6800,600,7.6500,7.6700,213,2
AGO-E,214,100,26.1400,100,25.8800,26.0600,214,0
TGLS,214,100,7.3200,200,7.2400,7.4150,214,0
MCHX,212,100,2.8000,500,2.7200,2.7500,212,0
MRSK,212,4788,28.2100,5000,28.1200,28.2100,212,0
FLDR,211,50,50.9900,400,50.9800,50.9500,211,0
MUE,211,100,13.3400,100,13.2100,13.2700,111,100
SPBO,211,400,35.7600,100,35.7100,35.7550,100,111
SREA,211,100,27.6400,100,27.3800,27.5500,211,0
ISDR,210,100,22.3700,100,21.9200,22.2000,206,4
RIV,210,200,16.7700,100,16.6400,16.7600,210,0
RSVAW,210,1000,4.5000,200,3.9500,4.0500,100,110
SLX,210,1800,47.0100,300,46.9600,47.2700,210,0
LNGR,209,100,29.2700,100,29.1900,29.3000,209,0
TAGS,209,100,22.3300,100,21.9900,22.1400,109,100
ALTS,208,500,37.6400,1292,37.5400,37.5400,208,0
NYV,208,200,14.9200,100,14.8400,14.8900,0,208
OCCI,208,100,13.3500,100,13.2000,13.2800,208,0
SUNS,208,400,15.5000,100,15.3900,15.4200,208,0
CPIX,207,19,3.2700,2,3.2200,3.2400,207,0
MFUS,207,100,35.1900,100,34.8400,34.9800,207,0
MNDO,207,400,2.7000,2,2.6800,2.6900,207,0
VFMV,206,3210,92.3700,900,92.2900,92.0900,206,0
WHF,206,100,13.6300,100,13.5000,13.5600,206,0
SWKH,205,1,13.4600,100,13.2300,13.3800,205,0
VMAC,205,100,10.3300,100,10.2100,10.3200,205,0
CNBS,204,300,24.1800,300,24.0500,23.9800,204,0
EJAN,204,400,30.4700,500,30.3200,30.3700,204,0
FEMS,204,100,42.9300,400,42.6000,42.8500,204,0
TPHS,204,200,2.0000,200,1.9300,2.0000,204,0
COF-G,203,100,26.5100,100,26.0700,26.3000,203,0
PFIE,203,200,1.1000,200,1.0500,1.0900,203,0
PTPI,203,100,4.1500,100,4.0300,4.1300,203,0
APEN,202,100,4.0400,100,3.9200,3.9900,202,0
CPER,201,500,22.6200,12,22.4700,22.5200,201,0
CSQ,201,400,16.0600,100,15.9600,16.0600,201,0
CXH,201,200,9.8000,200,9.7100,9.7900,201,0
GOAT,201,1000,36.2200,1000,36.1900,36.2200,201,0
LNFA+,201,124,1.8600,100,1.2800,1.6900,201,0
MGF,201,1000,4.5400,1500,4.5000,4.5200,201,0
MLVF,201,100,17.0000,400,16.8500,16.9000,201,0
PIN,201,400,24.4100,400,24.2600,24.3000,201,0
TRT,201,100,4.6400,100,4.4200,4.4500,200,1
ACACU,200,100,12.2100,100,11.9100,12.1200,200,0
ACV,200,100,34.3400,100,34.0700,34.2000,100,100
ADVWW,200,100,2.2000,212,2.1400,2.1700,200,0
ALYA,200,100,2.4700,100,2.3900,2.4200,200,0
AMER,200,1000,27.3700,200,27.3400,27.3400,200,0
ATAC+,200,100,2.2600,100,2.1600,2.0800,200,0
ATH-D,200,100,25.2000,100,25.0200,25.0900,200,0
AZAA,200,200,26.4200,300,26.2200,26.3200,200,0
BAC-A,200,100,25.5600,100,25.3700,25.4800,200,0
BAC-C,200,100,25.1000,3131,24.9800,24.9900,200,0
BAC-N,200,100,26.9000,100,26.6700,26.8800,100,100
BGRN,200,300,55.9100,300,55.7600,55.9000,200,0
BMED,200,1000,31.4300,1000,31.3300,31.8100,200,0
CACG,200,2000,44.9700,2000,44.7700,44.8300,200,0
CDR-C,200,100,22.7000,100,22.4500,22.6800,100,100
CHGX,200,600,29.5700,600,29.5500,29.5300,200,0
CINR,200,100,14.0700,200,14.0000,14.2800,0,200
CLA+,200,100,3.4100,100,3.3300,3.3500,200,0
COF-H,200,200,26.5100,100,26.1700,26.4200,0,200
CPZ,200,100,18.3200,100,17.9500,18.1200,200,0
CTDD,200,100,26.1500,100,26.0000,26.1000,0,200
CVEO,200,100,17.0400,100,16.8900,17.0200,200,0
CWS,200,100,44.0600,200,43.8000,43.8800,200,0
DHCNI,200,100,23.8300,100,23.4300,23.6600,200,0
DINT,200,500,25.0600,500,24.8100,24.8800,200,0
ELTK,200,100,5.6400,100,5.4200,5.5000,1,199
EPR-G,200,100,23.5000,100,23.0100,23.3400,200,0
ETB,200,100,14.9500,100,14.8000,14.8600,200,0
ETHO,200,100,56.3700,100,55.7700,55.8600,200,0
EUO,200,2200,22.7200,2000,22.7100,22.7400,200,0
EXD,200,100,10.2000,100,10.0600,10.1000,200,0
FBIOP,200,100,20.7300,100,20.4200,20.6500,100,100
FEMB,200,100,37.8700,200,37.5000,37.6500,200,0
FMF,200,700,46.4800,700,45.9000,46.4900,200,0
FOF,200,100,12.9900,100,12.8600,12.9200,200,0
GIGM,200,100,3.3800,200,3.2600,3.3000,200,0
GNPK+,200,100,2.2300,100,2.0700,2.2800,200,0
GOVXW,200,100,1.2000,100,1.0500,1.0100,200,0
GRNV,200,100,10.5000,100,10.3100,10.3000,200,0
GS-D,200,100,25.0200,100,24.9000,24.9500,200,0
HIE,200,100,8.3500,100,8.2700,8.2000,200,0
HT-C,200,100,19.8100,100,19.4300,19.6100,200,0
IACA+,200,100,3.6800,100,3.5600,3.6000,200,0
IBTH,200,35000,26.0200,35000,26.0100,26.0200,200,0
IHTA,200,100,9.0200,100,8.8900,8.9700,200,0
IIAC=,200,377,11.3700,900,11.2500,11.4300,200,0
IUSS,200,100,31.8900,500,31.8000,31.8300,200,0
JHS,200,200,15.4500,202,15.3200,15.4200,200,0
JMUB,200,3900,55.1400,4177,55.0600,55.1300,200,0
JPI,200,100,24.2900,100,24.0800,24.2200,100,100
LEXXW,200,200,2.2900,200,1.8500,2.1400,200,0
LNFA=,200,500,11.2300,900,11.1300,11.2000,200,0
LYL,200,100,2.6700,100,2.5400,2.6600,200,0
MFL,200,400,14.4500,100,14.4000,14.4000,0,200
MMU,200,100,13.2200,100,13.0800,12.9800,200,0
MPLN+,200,100,1.4300,100,1.3000,1.4000,200,0
MVT,200,5,15.3000,100,15.2200,15.3250,200,0
MYF,200,200,14.0800,100,14.0100,14.0700,200,0
NAII,200,100,13.3000,100,12.9300,13.0600,200,0
NBA+,200,200,1.1800,100,1.0500,1.2100,200,0
NBACW,200,100,3.0100,100,2.9100,2.9500,200,0
NBTX,200,100,19.5700,300,19.2000,19.2300,200,0
NEE-K,200,100,26.0200,100,25.7800,25.9700,200,0
NEE-O,200,100,63.2700,200,63.1600,63.3900,200,0
NHIC,200,100,10.5300,1,10.3700,10.3900,200,0
NTZ,200,120,12.2400,100,11.9600,11.9500,0,200
NUW,200,100,16.5300,300,16.3500,16.3850,200,0
OIA,200,100,7.8800,200,7.8100,7.8500,100,100
OTRKP,200,100,24.4000,100,24.1600,24.0600,0,200
PBJ,200,500,36.8500,300,36.7900,36.8300,200,0
PFIG,200,1000,27.3600,1000,27.2400,27.2500,200,0
PJUL,200,400,28.9700,2000,28.9000,28.9200,200,0
PMF,200,100,14.2000,100,14.0900,14.1500,100,100
PNNTG,200,100,25.3500,100,25.1000,25.2000,0,200
PUK-,200,100,27.6100,100,27.5600,27.5500,200,0
RACA,200,100,14.5300,100,13.9000,13.9300,200,0
RAYC,200,400,28.1000,400,27.9000,28.0300,200,0
RF-C,200,100,29.1900,100,28.9000,29.1900,200,0
RILYP,200,100,26.1500,100,25.8000,25.9600,200,0
ROBT,200,300,55.3200,300,55.1800,55.2100,200,0
RZG,200,100,154.1700,100,153.2700,156.8500,200,0
SDOG,200,4440,46.4500,5030,46.4200,46.4900,200,0
SHI,200,100,23.9900,100,23.7600,23.8500,200,0
SOAC+,200,100,2.8600,100,2.7600,2.8000,200,0
SSBI,200,100,16.4600,100,16.1900,16.0000,200,0
STAG-C,200,100,25.5400,100,25.2300,25.3400,200,0
STK,200,100,29.5600,100,29.3100,29.1800,200,0
STWOU,200,100,11.2000,100,10.9800,11.1900,200,0
TDF,200,100,25.4000,100,25.1600,25.2400,200,0
THWWW,200,200,0.1148,200,0.0591,0.0812,0,200
TMPM,200,100,10.3400,100,10.1600,10.2200,200,0
TVC,200,100,25.6800,100,25.4100,25.6000,0,200
TWIN,200,100,9.0300,100,8.8400,8.8700,200,0
UDN,200,5200,21.7200,4400,21.7100,21.6950,200,0
UNMA,200,100,27.1900,100,26.9200,27.2600,200,0
VALT,200,100,49.8200,100,49.7700,49.8300,200,0
VCV,200,100,13.1400,100,13.0300,13.0900,200,0
VGI,200,100,11.8200,100,11.7500,11.8300,100,100
VIDI,200,100,26.5000,100,26.2300,26.2900,200,0
VLT,200,100,13.7300,100,13.5900,13.6600,200,0
WFC-O,200,100,25.4200,100,25.3100,25.4900,200,0
WFC-Y,200,100,26.4800,60,26.3100,26.3600,200,0
XCEM,200,100,32.6100,100,32.0100,32.4700,200,0
YAC+,200,100,1.9300,100,1.7100,1.8050,200,0
HEQ,199,100,11.7000,100,11.5900,11.6300,199,0
SFTW=,199,100,12.4000,100,11.9100,12.3600,199,0
PSA-H,198,100,28.1600,100,27.8200,27.9300,20,178
TPZ,198,100,11.7100,100,11.6000,11.7000,198,0
CBFV,197,100,19.1700,25,18.7500,18.8100,197,0
KIM-L,197,100,26.0000,100,25.6600,25.7700,197,0
FRT-C,196,100,25.5600,100,25.3400,25.5100,196,0
VNO-M,196,100,26.1700,100,25.9400,26.1500,100,96
FMAO,195,100,24.2800,100,24.0500,24.0500,195,0
MCN,195,100,7.2300,100,7.1400,7.2200,195,0
COKE,194,100,258.7900,100,254.2800,256.3200,194,0
DLR-K,194,500,27.3400,100,27.1900,27.3300,194,0
DSX-B,194,100,25.8000,100,25.4700,25.7000,194,0
MTEX,194,100,19.4900,100,18.8300,18.6900,194,0
MTCN,193,100,55.6300,100,55.2400,55.6800,100,93
SB-C,193,100,21.1800,100,20.7800,20.7300,193,0
AZBL,192,100,26.2000,100,25.9200,26.0900,192,0
AGNCM,191,100,24.8900,100,24.7500,24.9400,191,0
NORW,191,900,13.3700,900,13.2300,13.3100,191,0
LEAP+,190,100,5.3700,100,5.0400,4.8600,190,0
NRT,190,100,3.8800,100,3.8100,3.7500,190,0
MVV,189,500,54.0800,1200,54.0300,54.0050,189,0
SNSR,189,500,34.1400,700,34.0400,33.9500,189,0
BFTR,188,1200,52.3000,200,52.2100,52.1600,188,0
SPUU,187,110,78.8600,500,78.7900,78.8400,187,0
IVOV,183,200,139.3500,200,139.2400,140.0000,183,0
NUDM,183,73,30.2600,300,30.1500,30.2100,183,0
TWO-E,183,100,24.4400,100,24.1600,24.2550,183,0
FDBC,182,100,58.9000,100,54.7800,56.7000,182,0
PWZ,182,300,28.0500,861,27.9200,27.9300,182,0
SMN,182,480,9.3800,378,9.3400,9.3300,182,0
AQNA,181,100,28.2300,100,27.8000,28.2000,181,0
NC,181,100,24.0700,100,23.6100,24.1100,181,0
CPSS,180,100,4.6200,100,4.5200,4.5450,180,0
TEKKU,180,100,11.4300,100,11.2100,11.1000,140,40
SIVBP,177,100,26.5000,100,26.2800,26.4600,177,0
COF-K,176,22,25.8800,2,25.8600,25.8600,176,0
FRC-G,173,100,25.4400,100,25.2300,25.3200,100,73
IEUS,173,100,64.6500,100,64.3400,64.6100,173,0
PSCT,173,100,135.7400,200,135.4500,135.4000,173,0
CFFI,172,100,38.9500,100,38.3900,38.4400,172,0
BML-H,169,100,22.4100,100,22.1300,22.2100,0,169
SOJB,169,100,26.2400,100,25.9800,26.2900,167,2
IQM,168,2000,47.8100,5,47.7100,47.6500,168,0
SMLP,167,100,16.2500,100,15.9600,15.9100,134,33
MOON,165,2100,38.2600,2100,38.1500,38.1900,30,135
PLPC,165,100,69.2700,100,67.9500,68.2100,165,0
PNQI,165,100,242.2500,40,242.1100,242.1300,165,0
QARP,165,100,35.1200,100,34.9300,35.0000,165,0
SQEW,165,100,34.4900,800,34.3000,34.2800,165,0
VAMO,165,100,21.2400,700,21.1700,21.1500,165,0
NTIC,164,100,14.0500,100,13.6400,14.0000,164,0
PSC,164,32,39.6300,32,39.5300,39.6100,100,64
JPM-J,163,100,26.7400,100,26.4200,26.5500,163,0
PCSB,161,100,15.7500,5,15.6700,15.7400,161,0
ID,160,50,7.2000,100,7.1200,7.1200,103,57
EZM,159,300,46.2600,500,46.2200,46.4100,159,0
CFG-E,158,100,26.2200,100,26.0200,26.1900,158,0
PEB-F,158,100,23.5300,100,23.3600,23.4500,158,0
ROKT,157,500,39.8500,100,39.8000,39.7500,151,6
QVAL,156,300,30.2400,500,30.2200,30.1900,156,0
TAXF,156,300,54.9500,1500,54.7900,54.8450,156,0
CLEU,155,1,3.8400,55,3.8000,3.8000,155,0
PALC,155,1400,32.1600,1400,32.0800,32.1600,155,0
CPTA,153,100,16.5300,100,16.1700,16.3900,153,0
EFO,153,200,47.0000,17,46.5000,47.8600,153,0
PGJ,153,500,72.6900,500,71.9600,71.7200,153,0
YVR,153,5,1.8200,100,1.7800,1.8200,153,0
BHK,151,100,16.2400,100,16.1100,16.2100,151,0
FCTR,151,9800,31.0300,300,30.9700,31.5700,151,0
VSDA,151,500,39.6600,500,39.6300,39.6300,151,0
EEV,150,753,15.0400,900,15.0200,15.1450,150,0
MBCN,150,200,19.7100,60,19.4800,19.4800,150,0
USEQ,150,100,32.1600,2100,32.0600,32.4800,150,0
VEGN,150,5000,35.7400,5000,35.6900,35.7200,150,0
VTRU,150,100,15.3100,100,14.7700,15.5000,150,0
LMPX,149,100,25.5000,1,25.1600,25.2400,49,100
VMOT,148,700,27.9100,700,27.8800,27.8600,148,0
SDEM,147,200,12.0000,200,11.9300,11.9750,147,0
SIMS,147,500,45.6900,500,45.5700,45.6500,147,0
TSOC,147,100,28.6300,240,28.5000,28.5600,147,0
DDEC,146,700,30.7600,300,30.7000,30.6700,146,0
DDG,146,36,22.6300,35,22.5800,22.6300,2,144
ATH-A,145,15,28.9600,100,28.7500,29.0800,145,0
PPH,145,400,70.0400,500,70.0000,70.0400,145,0
TECB,145,900,36.4300,600,36.4000,36.3400,145,0
VTWG,145,100,228.0900,400,227.7600,227.6000,100,45
IBD,144,200,26.5500,200,26.5100,26.5200,144,0
PSA-C,144,100,25.6000,100,25.3500,25.4700,144,0
SBB,144,40,20.0500,40,20.0200,20.0800,144,0
TDV,143,500,55.0600,500,55.0200,55.0300,143,0
TVE,143,100,25.8000,100,25.5600,25.7700,143,0
DIVO,141,300,33.4400,500,33.3800,33.4100,141,0
INVO,141,100,3.2000,100,3.0600,3.1100,141,0
MLAB,140,100,291.0400,80,288.1400,290.3300,140,0
CCV=,138,100,11.4000,100,11.2900,11.2900,138,0
DYFN,136,100,18.7700,100,18.5500,18.5000,136,0
EFAX,136,100,80.2200,100,79.8500,80.2600,136,0
WTT,136,400,2.0700,500,1.9900,2.0400,136,0
CLNY-I,135,100,24.0100,100,23.7600,23.8900,100,35
IHC,135,100,41.9800,5,40.9000,41.0100,135,0
IHY,135,400,25.9700,500,25.8400,25.8400,135,0
KAIRU,135,200,10.9200,20,10.3700,10.3900,135,0
NFRA,135,700,54.7100,1000,54.5400,54.6650,135,0
DJD,134,1600,40.0800,34,40.0200,40.0300,134,0
EAOA,134,300,31.5100,400,31.4700,31.4900,134,0
EPR-E,133,100,34.3600,100,33.7500,33.7500,133,0
HEGD,133,400,17.0600,7073,17.0300,17.0700,133,0
PRS,133,100,28.0200,100,27.6600,27.9100,125,8
BTEK,132,1000,38.6800,1000,38.6200,38.6500,132,0
FRC-H,132,100,26.4300,100,26.0700,26.2700,132,0
LEVL,132,105,20.1000,100,19.7300,20.1000,132,0
PLBC,132,100,25.4300,100,24.9700,25.0800,132,0
IBHE,131,250,25.0200,53,24.9700,25.0000,131,0
NWLI,131,100,208.1200,42,203.8100,207.4300,131,0
DMB,130,100,14.5000,100,14.4000,14.4600,130,0
HOMZ,130,800,34.5900,800,34.4900,34.2300,130,0
ICBK,130,100,20.4800,100,20.2500,20.3800,130,0
NWFL,130,100,25.9500,100,25.4300,25.6400,130,0
AC,129,100,35.3600,100,34.9000,35.0600,129,0
BGT,129,100,12.3900,100,12.2900,12.3400,128,1
CIZN,129,100,20.4300,1,19.7600,20.0000,129,0
WFC-N,129,100,25.8500,100,25.6000,25.7800,129,0
AZYO,128,100,15.3000,100,14.7000,15.2000,128,0
GOVZ,128,1027,22.2500,1338,22.2300,22.2400,128,0
AFGC,125,100,27.3000,100,26.9100,27.1500,125,0
SMOG,125,500,190.2600,500,188.3000,187.1400,91,34
VCLO,125,100,12.5500,100,12.4700,12.6000,125,0
WTFCP,125,100,28.1700,100,27.9700,28.0200,25,100
LEND,124,100,15.1100,100,15.0400,15.1100,124,0
WCC-A,124,100,30.6200,100,30.3400,30.5800,24,100
IECS,123,500,30.0800,400,30.0600,30.3000,123,0
MZZ,123,600,11.4800,70,11.4600,11.4700,123,0
PWS,123,200,30.2300,600,30.1800,30.5700,123,0
MS-E,121,100,29.0200,100,28.7000,28.8600,121,0
VERY,121,100,9.3800,100,9.0600,9.3700,121,0
EWX,120,2600,53.1000,20,52.9300,52.9600,120,0
FSD,120,100,14.9700,100,14.8500,14.9100,0,120
HTLFP,120,100,27.7600,100,26.9700,27.5400,0,120
URNM,120,300,44.1600,300,43.8500,43.8100,120,0
VNCE,120,100,9.1200,100,8.7400,9.0700,120,0
HT-D,119,100,18.9000,100,18.6800,18.7900,119,0
ALACR,118,300,0.9400,200,0.8400,0.8906,118,0
CZWI,118,100,11.0100,9,10.8500,10.8500,118,0
EAOR,117,300,29.8000,300,29.7700,29.8000,117,0
GNRSU,117,400,12.9600,300,12.0800,12.3400,117,0
VOYA-B,117,100,28.1800,100,27.9000,28.2900,117,0
AHAC,116,100,10.2700,400,10.1800,10.2000,116,0
PTF,116,100,153.4500,30,153.2900,152.8900,102,14
ACND+,115,100,1.9000,100,1.8400,1.9000,115,0
IIVIP,115,89,381.7300,100,381.1100,381.6600,100,15
MDWT,115,100,56.6200,100,54.2900,56.0000,115,0
PSA-I,115,100,26.7800,100,26.5200,26.5800,115,0
SPGP,115,150,75.9900,200,75.9500,76.0200,115,0
ASRV,114,100,3.6100,2,3.4500,3.4800,114,0
ECC,114,25,11.3100,100,11.2000,11.2650,114,0
KSCD,114,100,26.6800,100,26.4000,26.4950,114,0
PSA-E,114,100,25.7800,100,25.6200,25.6400,114,0
WAFU,114,100,4.5400,100,4.4100,4.5300,114,0
BMLP,113,100,38.2500,100,38.0100,38.1800,113,0
DLA,113,100,21.8600,100,21.2200,21.3600,113,0
IHIT,112,100,8.8500,200,8.7900,8.8500,112,0
JHMS,112,2500,32.0100,2500,31.9400,32.0250,112,0
NEWA,112,100,3.6100,100,3.4900,3.5500,102,10
UBT,112,100,57.0200,1700,56.6100,57.0200,112,0
BXP-B,111,100,25.4300,100,25.1900,25.3000,111,0
OFLX,111,1,151.1200,100,146.3300,150.8700,109,2
SJIU,111,100,36.1900,200,36.0300,36.1200,111,0
IEFN,110,600,26.5100,100,26.4900,26.4800,110,0
OMEG,110,40,10.6100,1000,10.5000,10.5200,110,0
OVLY,110,8,16.0000,100,15.1500,15.4300,110,0
QQH,110,100,43.4600,100,43.0100,43.2000,110,0
RZV,110,100,73.9000,300,73.3400,73.9900,110,0
BPYPP,109,100,24.8200,100,24.6700,24.7650,109,0
VLYPO,109,100,25.8400,100,25.5000,25.6000,9,100
BOSS,108,100,31.9000,100,31.7900,31.7800,108,0
SLMBP,108,100,54.0500,100,52.7900,53.0100,108,0
TKAT,108,100,1.7800,100,1.6700,1.7400,108,0
PTK,107,100,10.4400,100,10.3200,10.4700,107,0
VTWV,107,300,124.9700,100,124.8200,124.2500,107,0
BHFAO,106,100,27.9400,100,27.6000,27.9300,106,0
IDNA,106,800,51.0800,300,50.9600,51.4000,106,0
SPQQ,106,800,29.5000,1000,29.4800,29.3500,106,0
DWLD,105,300,33.2900,600,33.0400,33.0750,5,100
IRS,105,100,4.8100,100,4.7000,4.7500,105,0
AIRT,104,100,21.9300,100,20.9600,21.6700,104,0
IRR,104,100,2.8500,100,2.8000,2.8400,104,0
SCJ,104,900,79.7900,100,79.2900,79.4500,100,4
DTJ,103,100,25.7600,100,25.5600,25.6600,0,103
FMAC+,103,100,2.4400,100,2.3400,2.4700,103,0
FNGS,103,500,117.6900,500,117.6200,117.6400,103,0
GCMGW,103,100,1.8900,100,1.7900,1.9000,103,0
BFY,102,200,14.5500,100,14.4500,14.4900,102,0
JRSH,102,500,5.8000,100,5.7400,5.7700,102,0
MFIN,102,100,5.2500,100,5.0400,5.3200,102,0
RGI,102,100,160.5500,200,160.4500,160.5300,102,0
SOCL,102,400,67.2700,100,67.1400,67.0000,102,0
SPYC,102,2500,27.8100,2500,27.7800,27.7850,102,0
TMKRU,102,100,10.4400,201,10.3700,10.3800,102,0
UITB,102,100,54.3200,100,54.2900,54.2900,102,0
AIRR,101,500,37.2200,500,37.1300,37.2300,101,0
BFEB,101,2274,27.4500,800,27.4000,27.4100,101,0
DEF,101,3190,59.8600,18140,59.5900,59.7800,101,0
DEFA,101,1000,31.1100,1000,31.0800,31.0500,101,0
DVYA,101,100,40.6500,100,40.2000,40.1800,101,0
FLMB,101,200,27.4300,200,27.3400,27.4100,101,0
FLSP,101,100,19.9900,100,19.8700,19.8700,101,0
FNI,101,500,66.1100,100,66.0000,65.0600,101,0
IBA,101,200,44.4600,100,43.7700,44.1300,100,1
IQDE,101,300,23.8100,300,23.5700,23.7000,101,0
LJAQU,101,200,10.8600,500,10.0900,10.3500,101,0
MAGS,101,100,4.4400,100,4.3600,4.3700,101,0
NREF,101,100,16.8400,1,16.5500,16.7000,101,0
PSCX,101,3000,21.0300,3000,20.9100,21.0200,101,0
SYNL,101,100,8.9000,100,8.8000,8.7100,101,0
AAIC-C,100,200,22.4700,200,20.0900,21.4100,100,0
ADEX=,100,100,10.4900,200,10.3800,10.3700,100,0
ADOC,100,200,10.3400,200,10.2300,10.2900,100,0
AHH-A,100,100,25.5300,100,25.1500,25.4000,100,0
AHL-D,100,100,26.3100,100,25.9700,26.3400,100,0
AIQ,100,100,28.8100,700,28.7400,28.7700,100,0
AMHCW,100,100,1.6200,100,1.4700,1.4600,100,0
ARDC,100,100,14.6400,100,14.5800,14.6400,100,0
ATV,100,200,20.9500,100,20.7500,20.8500,100,0
AVIG,100,500,50.0200,500,49.9600,50.0100,100,0
BBK,100,100,16.2400,100,16.0900,16.1700,100,0
BCD,100,100,26.0400,100,25.9500,26.1000,100,0
BCV,100,100,32.0200,100,31.6100,31.8500,0,100
BEDU,100,800,6.4900,200,6.3900,6.5200,100,0
BGLD,100,2600,20.0800,100,19.9400,20.0800,100,0
BGX,100,100,13.9800,80,13.9000,13.9800,100,0
BHR-B,100,100,16.7400,100,16.2300,16.9100,0,100
BIT,100,100,17.4600,100,17.3000,17.4800,100,0
BPYPO,100,100,24.7800,100,24.4900,24.5000,100,0
BPYUP,100,100,24.8700,100,24.6600,24.8700,100,0
BSCU,100,500,20.0600,500,20.0000,20.0400,100,0
BSJR,100,100,25.5400,100,25.4900,25.5400,100,0
BSML,100,100,25.3500,100,25.2800,25.3400,100,0
BTA,100,100,12.8600,100,12.7400,12.7700,0,100
BUFD,100,1000,20.1300,1700,20.0100,20.1300,100,0
CBH,100,100,10.0300,200,9.9600,9.9900,100,0
CDOR,100,2,4.6200,100,4.5300,4.5000,100,0
CGO,100,100,15.7700,100,15.5400,15.5500,100,0
CHFW,100,100,10.3400,100,10.2800,10.1600,100,0
CHIK,100,100,37.6300,100,37.0600,37.4600,100,0
CIM-B,100,100,23.9900,100,23.7300,23.8700,100,0
CLDB,100,100,18.5700,100,18.2500,18.8800,100,0
CLRBZ,100,100,0.1686,100,0.1536,0.1690,99,1
CMRE-C,100,100,25.3900,100,25.1000,25.2000,100,0
CNO-A,100,100,25.6800,100,25.3900,25.4900,82,18
COM,100,300,26.2800,100,26.1000,26.2250,100,0
COWNL,100,100,27.2800,100,26.8500,27.1500,0,100
CTAC+,100,100,1.9400,100,1.7800,1.8600,100,0
CVY,100,2200,21.1400,100,21.1100,21.0400,0,100
CXDO,100,1,7.3400,100,7.1200,7.2600,100,0
CZA,100,100,79.3500,600,78.5900,78.9300,0,100
DAIO,100,100,5.3100,100,5.2000,5.2400,100,0
DALI,100,100,23.3800,500,23.3600,23.2900,100,0
DAUG,100,4324,33.3000,7400,33.2600,33.2800,100,0
DBDR,100,400,10.4400,1,10.4000,10.4300,100,0
DBEZ,100,1300,33.9500,1000,33.9000,33.8800,100,0
DEEF,100,200,31.1100,200,30.7600,31.0200,100,0
DEH=,100,300,11.0900,900,10.9800,10.8800,100,0
DFHTU,100,100,17.6800,100,15.9500,15.8000,100,0
DFPHW,100,100,2.0900,100,1.8100,1.8000,100,0
DISCB,100,100,40.2000,90,37.5000,37.3900,100,0
DJUN,100,100,32.5000,200,32.4700,32.4800,100,0
DLR-C,100,100,25.8500,100,25.4900,25.7400,100,0
DMO,100,100,14.2400,100,14.1100,14.2700,100,0
DSACU,100,30,11.0000,200,10.8600,10.9100,100,0
DSACW,100,100,1.6900,300,1.4600,1.5300,100,0
DSEP,100,59,31.3100,1200,31.2100,31.3200,100,0
DWEQ,100,700,29.0700,100,29.0200,29.0600,100,0
ECLN,100,500,23.2900,500,23.2500,23.2600,100,0
EDRY,100,100,6.5100,100,6.2400,6.4200,100,0
EFZ,100,3500,19.7200,9300,19.7000,19.7000,100,0
EGPT,100,100,27.3400,300,26.7600,27.1700,100,0
ELD,100,200,34.7800,200,34.2400,34.5700,0,100
EMP,100,100,26.3900,100,26.1500,26.1200,100,0
EQS,100,200,1.7400,200,1.6000,1.6700,100,0
EWCO,100,200,32.7300,200,32.5100,32.5800,100,0
FCACW,100,200,2.4600,100,2.3200,2.5100,100,0
FCO,100,100,8.0300,100,7.9400,7.9900,100,0
FGNA=,100,100,11.8000,10,11.6800,11.6800,100,0
FIIIU,100,400,14.0000,900,13.8000,13.9100,100,0
FIV,100,100,9.2800,100,9.2100,9.2100,0,100
FLLA,100,400,23.4600,100,23.2700,23.4600,100,0
FRC-J,100,100,26.1200,100,25.8800,25.9500,100,0
GAM-B,100,100,27.2000,100,26.5700,26.6800,0,100
GB,100,100,12.8900,100,12.5100,12.6400,100,0
GB+,100,100,1.4800,100,1.3600,1.4700,100,0
GFNCP,100,100,104.1600,100,102.1800,103.3300,0,100
GGM,100,100,20.2400,100,20.0400,20.1100,100,0
GHYB,100,300,50.4100,300,50.2900,50.3600,100,0
GIGE,100,100,41.0100,100,40.5700,40.2000,0,100
GJT,100,100,20.9800,100,20.3700,20.4500,0,100
GMTA,100,100,25.9400,100,25.6700,25.8800,100,0
GS-N,100,100,26.0300,100,25.7700,25.9200,0,100
GSST,100,4200,50.8100,4300,50.7900,50.7500,0,100
GSY,100,6040,50.5700,1700,50.5600,50.5650,100,0
GTO,100,1248,57.3500,300,57.2200,57.2100,100,0
GUT-A,100,100,28.2300,100,26.8000,27.0000,100,0
GXC,100,200,146.3100,80,146.1300,146.1300,100,0
HCARU,100,100,10.7900,200,10.6600,10.7600,100,0
HDLB,100,100,12.8000,100,12.6800,12.7000,100,0
HEWJ,100,1500,36.7600,1300,36.7100,36.7300,0,100
HIGA+,100,200,1.7800,100,1.6200,1.7300,100,0
HOL,100,100,10.4400,100,10.3100,10.4000,100,0
HT-E,100,100,18.8800,100,18.7100,18.9500,100,0
HYLD,100,200,32.3700,200,32.2700,32.3100,100,0
HZAC+,100,100,1.9900,100,1.8900,2.0000,100,0
IACA=,100,400,13.4000,900,13.0500,13.3700,100,0
IAI,100,400,84.9700,400,84.9100,85.0300,100,0
IBDV,100,100,26.0700,100,25.8100,25.9700,100,0
IBTI,100,34900,26.0500,34900,26.0300,26.0500,100,0
IDMO,100,100,34.8200,100,34.7300,34.7200,100,0
IGOV,100,3000,55.0700,3100,54.8500,54.9550,100,0
IHYF,100,100,25.5900,100,25.5400,25.5900,100,0
IIIIU,100,100,11.1800,100,11.0900,11.0000,100,0
IJAN,100,400,25.9200,145,25.7900,26.0600,100,0
INAQU,100,400,18.4100,122,18.1000,18.2500,100,0
IPLDP,100,100,26.4600,100,26.0500,26.2800,100,0
IQDF,100,400,25.3600,200,25.2300,25.1600,100,0
IUS,100,100,32.7400,500,32.7200,32.6500,100,0
IVLU,100,100,23.9900,100,23.8000,23.8600,100,0
JAX,100,200,7.6400,100,7.5100,7.5800,100,0
JCTCF,100,100,9.9800,100,9.8700,9.9500,100,0
JGLD,100,100,27.8600,100,27.5400,27.7800,100,0
JHMH,100,2500,45.3300,2500,45.2500,45.6000,100,0
JJG,100,300,58.0800,200,57.7000,58.4800,100,0
JLS,100,100,19.8500,100,19.6900,19.7100,100,0
JPIN,100,500,60.5500,700,60.2800,60.4600,100,0
JYAC,100,100,10.5200,100,10.4800,10.5000,100,0
KBUY,100,300,27.7900,100,27.6700,27.7100,100,0
KORP,100,300,52.9400,200,52.8900,52.9300,100,0
KRMA,100,600,28.2200,100,28.1300,28.1700,100,0
KSM,100,100,11.6100,100,11.4600,11.5300,100,0
LACQW,100,200,1.1500,100,1.0900,1.1200,100,0
LGH,100,100,34.4500,100,34.1000,34.1600,100,0
LWACU,100,100,10.4900,100,10.4200,10.4100,100,0
MCA,100,100,14.9700,100,14.8500,14.9000,0,100
MCR,100,200,8.6400,100,8.6000,8.6300,100,0
MDLQ,100,100,8.2800,100,8.0600,8.2800,100,0
MDVL,100,100,13.9600,100,13.6300,13.8800,100,0
MMD,100,100,22.3200,100,22.0300,22.1800,0,100
MMT,100,100,6.2100,100,6.1200,6.1900,100,0
MQY,100,100,17.1200,100,16.9400,17.0000,100,0
MS-I,100,100,29.0000,100,28.6400,28.8300,0,100
MSVX,100,100,23.8600,100,23.7700,23.7700,100,0
MUJ,100,200,14.5200,100,14.3900,14.4400,100,0
MYC,100,100,14.7000,100,14.5900,14.6200,100,0
NHA,100,100,9.8800,8800,9.8400,9.8450,100,0
NIM,100,100,10.7800,100,10.6900,10.7000,100,0
NIQ,100,100,14.5900,100,14.4200,14.5250,100,0
NMMCW,100,100,2.1200,100,1.7600,1.8000,0,100
NQP,100,200,14.1800,100,14.1100,14.1500,100,0
NRZ-A,100,100,24.0600,1000,23.8600,24.2600,100,0
NXN,100,100,14.3000,100,14.1300,14.2500,100,0
NXP,100,100,17.1900,100,17.0100,17.0900,100,0
PBB,100,100,25.3100,100,25.0800,25.1900,0,100
PCOM,100,100,15.3000,100,15.0700,15.2150,100,0
PGZ,100,100,12.2700,100,12.1600,12.1600,100,0
PIZ,100,500,34.8500,400,34.6900,34.8000,100,0
PKB,100,500,45.4300,100,45.3600,45.6200,100,0
PMD,100,100,5.3900,100,5.2700,5.3200,100,0
PMX,100,2700,12.2000,100,12.1300,12.0900,100,0
PPIH,100,100,6.2100,100,6.0900,6.1450,100,0
PSB-X,100,100,26.3400,100,26.0900,26.1300,100,0
PSB-Y,100,100,26.3100,100,26.0000,26.1200,100,0
PSHG,100,100,5.3800,100,5.2600,5.3500,100,0
PTK+,100,29986,1.0900,100,1.0100,1.0900,100,0
PZG,100,600,1.1800,188,1.1400,1.1500,100,0
PZT,100,200,26.2800,200,26.0400,26.1650,100,0
RAACU,100,100,10.8600,100,10.7200,10.8900,100,0
REXR-A,100,100,25.3900,100,25.1300,25.2700,100,0
RRBI,100,100,52.4300,100,51.8000,52.2500,100,0
RSSS,100,100,2.5900,100,2.5100,2.5500,100,0
RTPZ+,100,100,4.2600,100,2.2700,3.2500,0,100
SCE-K,100,100,25.4000,100,25.2000,25.2800,100,0
SCX,100,100,4.8500,100,4.5900,4.7000,100,0
SGAMU,100,100,10.9900,200,10.8200,10.9500,100,0
SHO-E,100,100,24.5200,100,24.2600,24.4500,100,0
SNPR=,100,300,13.6100,900,13.5000,13.3300,100,0
SOLOW,100,100,6.0300,100,5.8100,5.8000,100,0
STKS,100,200,4.0900,300,3.9500,3.9800,100,0
SVBI,100,100,7.7200,100,7.4600,7.5800,100,0
SVSVU,100,2500,11.6300,100,11.3700,11.7600,100,0
TACT,100,100,10.1900,100,9.9300,10.0500,0,100
TDA,100,100,25.2200,100,25.0000,25.2300,100,0
TGP-B,100,100,25.3600,100,25.1400,25.2600,100,0
THBRU,100,100,16.0300,100,15.5400,15.4850,100,0
TIPZ,100,3100,65.6400,3100,65.4700,65.4900,100,0
TLTD,100,100,68.1100,100,67.8900,68.1000,100,0
TMPMU,100,100,10.9800,1,10.7500,10.7500,0,100
TNP-E,100,100,22.4500,100,22.2200,22.2200,100,0
TWCTW,100,100,2.2300,100,2.1000,2.1700,100,0
TWN,100,100,28.7100,100,28.2700,28.4450,100,0
UCC,100,100,90.4600,100,89.9300,90.3100,100,0
UCIB,100,100,15.9700,100,15.8200,15.9000,100,0
ULE,100,500,15.6400,500,15.6000,15.5700,100,0
ULVM,100,4200,58.5600,4200,58.4000,58.4050,100,0
UNAM,100,100,5.4400,1,4.9700,5.3600,100,0
VNO-K,100,100,25.3000,100,25.0700,25.2200,100,0
VNO-N,100,2100,26.1500,100,25.9300,26.1300,100,0
VSMV,100,500,34.8100,100,34.7400,34.7000,100,0
VTN,100,100,13.0700,100,12.9500,13.0000,0,100
WBIY,100,200,24.2300,100,24.1400,24.1400,100,0
WRB-G,100,100,25.8700,100,25.5500,25.7800,100,0
WSBCP,100,100,27.9800,100,27.4400,27.8700,100,0
XOUT,100,3000,37.1700,2200,37.0900,37.0800,100,0
XTLB,100,100,3.5400,200,3.3600,3.4600,100,0
ARL,99,100,9.7200,100,9.3100,9.5700,99,0
FCOR,99,100,56.7400,200,56.5100,56.5500,0,99
HIFS,99,100,232.9100,100,228.8500,230.3000,99,0
JCTR,98,500,51.9000,500,51.8400,51.9100,98,0
FLQM,96,2500,39.1700,100,39.0800,39.1100,96,0
MRBK,96,12,20.2700,12,19.8700,20.0000,96,0
PPX,96,100,26.3300,100,26.1000,26.2000,20,76
AMH-F,94,100,25.9100,100,25.6500,25.6700,94,0
EPV,94,753,15.2000,753,15.1600,15.3000,94,0
RILYM,94,100,25.3300,100,25.0800,25.2200,94,0
PSB-W,92,100,25.9500,100,25.6700,25.7750,92,0
RCD,92,100,129.9900,200,129.8900,129.5500,92,0
SB-D,92,100,21.0800,100,20.7700,21.0500,92,0
MS-F,90,900,28.7200,100,28.4900,28.6700,90,0
EIS,89,100,66.5900,100,65.9400,66.5000,86,3
SNOA,89,100,8.4100,100,8.2000,8.3900,89,0
FMBIP,88,100,28.1000,100,27.6400,28.0300,10,78
IVSG,88,600,12.6900,500,12.6700,12.6400,88,0
CFXA,87,100,165.9800,100,165.7500,166.7800,72,15
GBLI,87,100,27.8800,35,27.3500,27.7600,87,0
PIO,87,400,36.1800,500,35.9600,35.9950,87,0
FXG,86,500,52.3400,500,52.3100,52.5000,0,86
INN-D,86,100,24.4300,100,23.7000,23.8400,86,0
EASG,85,200,29.9400,200,29.8900,29.8900,85,0
EFIV,85,1200,35.9000,200,35.8700,35.8700,85,0
GHC,85,10,561.6000,10,559.4000,560.2000,61,24
RLY,85,2000,25.5400,2000,25.4400,25.4800,0,85
INTT,84,100,7.3900,100,7.3100,7.3300,84,0
RZLT,84,332,14.8500,34,14.4000,14.4000,84,0
SUMR,84,100,16.5600,100,16.1900,16.4100,84,0
WEA,84,59,14.1200,200,14.0200,14.1300,84,0
BC-B,83,100,27.1500,100,26.8000,27.1100,83,0
DFP,83,100,29.2700,100,29.0000,29.0800,83,0
KEQU,83,100,13.3000,100,12.7600,12.8400,83,0
ASB-F,81,100,27.6100,100,27.3700,27.5300,81,0
BSX-A,81,1,114.5300,100,113.8600,111.7500,81,0
CUBA,81,2,5.7500,100,5.5800,5.6200,81,0
DGZ,81,80,10.0700,79,9.9900,9.9900,81,0
JKK,80,100,332.1400,100,331.5700,331.3200,0,80
NATH,80,100,59.5300,100,58.0000,58.6200,80,0
WBS-F,80,100,26.1500,100,25.8100,26.0800,80,0
MUNI,79,100,56.8800,100,56.7200,56.8400,79,0
PXSAW,79,100,0.3500,1,0.2400,0.3400,79,0
UBR,79,23,33.2200,23,32.7900,32.6900,79,0
ACGLO,78,100,26.5300,100,26.2000,26.4100,78,0
BML-J,78,100,25.1800,100,24.9500,25.0600,78,0
FVAL,78,100,42.1600,200,42.1100,42.0700,78,0
NYMTN,77,100,23.2800,451,23.1500,23.1500,77,0
SYG,77,500,121.1100,500,120.9800,121.0900,77,0
VIST,77,100,2.7500,100,2.7000,2.7800,77,0
LBJ,76,10,77.7800,9,77.3800,77.5300,26,50
PSMG,76,1200,16.8300,800,16.7800,16.8100,76,0
AIZN,75,100,26.7400,100,26.4500,26.4800,75,0
CPAC,75,100,8.4100,100,7.7900,8.1000,75,0
KEMQ,75,400,35.9100,400,35.6900,35.9700,75,0
RF-A,75,100,26.0000,100,25.6600,25.8900,75,0
JHCS,72,2500,35.9200,2500,35.8600,35.9200,72,0
NHTC,72,100,5.5300,200,5.4300,5.4300,72,0
BBQ,71,100,6.0500,201,5.8000,6.0100,70,1
GLOP-B,71,100,18.1400,100,17.8300,17.8700,71,0
NYCB-A,71,100,29.3000,100,28.6600,29.2000,0,71
VLYPP,71,38,28.4900,100,28.2100,28.1500,71,0
BFIT,70,100,26.2300,100,26.1400,26.1900,70,0
FAD,70,1100,111.5500,200,111.2200,111.0200,70,0
QABA,69,700,48.7000,400,48.6500,48.2500,69,0
RNGR,69,100,4.8900,100,4.7400,4.8500,69,0
AVGOP,67,100,1512.8900,100,1506.6900,1502.8500,67,0
ITEQ,67,500,72.8400,100,72.5800,72.8200,67,0
EFU,66,866,12.1300,866,12.0900,12.0900,0,66
SF-A,66,100,26.0100,100,25.6800,26.0000,66,0
ALL-B,64,100,27.4200,100,27.1700,27.4000,64,0
SBR,64,100,30.5600,100,30.1300,30.2300,25,39
URE,63,12,62.3100,500,62.2500,62.1700,63,0
EQWL,62,1000,71.2600,1000,70.9200,71.0000,62,0
ITIC,62,100,150.8500,100,145.9300,147.8000,62,0
ENO,61,100,25.7600,100,25.3900,25.5000,61,0
INDT,61,100,67.6600,100,65.6000,67.4000,25,36
FFTI,60,3300,24.3300,527,24.2700,24.2600,60,0
LIXT,60,100,3.5400,100,3.2900,3.3000,60,0
RVRS,60,200,19.6600,9900,19.6300,19.5800,60,0
STPK=,60,300,37.9600,700,37.6300,37.7600,60,0
CHMG,59,50,34.8000,100,33.9000,33.7700,59,0
CODA,58,100,6.0500,1,5.8900,5.9500,58,0
PHAR,58,7,14.7000,100,14.5500,14.5300,58,0
SAL,58,100,36.8900,100,35.9100,36.4200,58,0
SPE,58,100,14.6100,200,14.5000,14.6100,58,0
DHIL,57,100,154.5300,200,150.7500,152.3100,57,0
FLC,57,100,23.4400,100,23.1300,23.2350,57,0
SOHON,57,100,14.0500,100,12.9800,12.9500,57,0
USLM,57,100,133.7400,100,130.7600,132.4000,57,0
VFLQ,57,1500,98.9200,900,98.8000,98.5100,57,0
CHN,56,100,33.2500,100,32.7900,33.0000,56,0
CHNA,56,100,38.8800,100,38.3500,38.4500,56,0
FFNW,56,128,12.8400,100,12.7400,12.8400,56,0
FLGB,56,200,23.5300,200,23.4600,23.4800,56,0
WRB-C,56,100,25.3700,100,25.2000,25.3000,56,0
DFJ,55,1800,73.2100,500,72.9100,72.8700,50,5
TRTN-C,55,100,26.9500,100,26.5900,26.9300,55,0
AMYT,54,32,14.2500,100,13.6700,13.7000,54,0
HGBL,54,100,2.9600,700,2.8600,2.9500,54,0
BEEMW,52,100,59.5300,100,58.2100,57.3500,0,52
IOO,52,1400,65.0700,1400,64.9300,64.9750,52,0
ORPH,52,100,13.7900,100,13.6000,13.7000,52,0
UDEC,52,11,28.6000,8200,28.5400,28.6000,52,0
BRID,51,100,18.1600,100,17.4300,17.5100,51,0
FVCB,51,215,15.5400,100,15.2700,15.5100,51,0
AINC,50,100,8.5200,100,8.1700,8.0200,50,0
ARCM,50,1400,100.3600,200,100.0600,100.2500,50,0
CRWS,50,100,7.5400,100,7.3800,7.4700,50,0
FPI-B,50,100,26.1400,100,25.8500,26.1700,50,0
GBAB,50,100,24.9700,100,24.7800,24.8750,50,0
LEDS,50,100,3.5300,100,3.4100,3.4500,50,0
RFM,50,100,22.0000,100,21.7700,21.8000,50,0
TNP-D,50,100,22.8900,100,22.6900,22.7900,50,0
VPC,50,300,21.6800,100,21.5100,21.5750,50,0
ASB-E,49,100,26.8500,100,26.5900,26.7700,49,0
ATCO-I,49,100,25.2700,100,25.0600,25.3000,49,0
NCB,49,200,15.4900,100,15.3900,15.4700,49,0
DNL,48,1100,80.4700,100,80.0600,80.4800,48,0
FNGZ,48,4413,3.7500,1700,3.7400,3.7400,48,0
PAYAW,48,100,4.0900,100,3.9300,4.0000,48,0
EEMD,47,400,22.9000,100,22.6400,22.6300,47,0
AUGZ,46,5000,28.4700,5000,28.3700,28.3600,46,0
JKL,46,100,150.1100,100,149.9700,150.2900,46,0
UPW,46,14,57.2000,14,56.9700,56.8600,46,0
UXI,45,10,103.4000,10,102.7000,103.5000,30,15
ATRI,44,1,708.5500,100,685.3100,708.0000,44,0
MXDU,44,700,38.7700,700,38.6200,38.6100,44,0
VIAO,44,100,14.4900,81,14.3100,14.1100,44,0
DMRM,42,1000,55.9700,100,54.7000,54.9200,42,0
YXI,42,2062,12.9900,1560,12.9600,12.9600,42,0
FLGR,41,100,25.3800,100,25.3500,25.3500,41,0
RDFI,40,3600,27.3000,200,27.2500,27.2000,40,0
ERM,39,500,21.9600,400,21.8500,21.8800,39,0
NANR,39,500,35.4800,400,35.4400,35.6400,39,0
HUSV,38,38,28.7500,700,28.7300,28.7800,38,0
GDXD,37,300,22.4400,37,22.3200,22.3900,37,0
UTRN,37,100,30.2700,100,29.9700,30.1600,37,0
AMRB,35,5,13.4000,100,12.8000,13.3400,35,0
ANEW,35,100,44.3800,100,44.3000,44.2900,35,0
ENFR,35,100,16.1700,500,16.0800,16.0000,35,0
IVDG,35,500,12.5700,500,12.5500,12.6000,35,0
WFIG,35,3900,55.0200,3900,54.9900,54.9500,35,0
FAII=,34,400,12.4800,500,12.3500,12.4550,34,0
SLG-I,34,100,25.4200,100,25.1800,25.3000,0,34
CODI-B,33,100,25.3400,100,25.1400,25.2400,33,0
RFIL,33,100,5.6800,100,5.6200,5.7000,0,33
STSB,33,800,44.0100,800,43.9100,43.6900,33,0
BFK,31,100,15.1400,100,15.0100,15.0300,31,0
EGIS,31,2100,28.0600,1700,28.0400,27.9700,31,0
PSA-N,31,100,25.3800,100,25.0500,25.2850,31,0
TWO-C,31,100,23.1100,100,22.8600,22.9400,31,0
BSEP,30,8000,29.7200,500,29.5900,29.6100,30,0
CEQP-,30,100,8.0800,100,8.0000,8.0500,30,0
CFA,30,300,64.3300,250,64.2900,64.2100,30,0
FITE,30,500,48.7100,500,48.6200,48.7800,30,0
ISRA,30,100,47.1400,100,46.8000,47.1700,30,0
SHE,30,1000,91.8400,100,91.7400,91.7900,30,0
SMID,30,100,10.9400,20,10.6400,10.8000,30,0
VFIN,30,2500,13.2200,2500,12.9600,12.9600,30,0
WIL,30,100,83.1000,60,82.5000,83.0000,30,0
BOUT,29,1000,35.6000,300,35.1200,35.2900,29,0
CTBB,29,200,25.8000,100,25.6800,25.7400,29,0
OBCI,29,100,12.3800,100,12.1200,12.1600,29,0
UZD,28,100,26.7000,100,26.2700,26.4800,28,0
LTL,27,100,43.2500,100,42.7900,42.8200,27,0
QQC,27,1000,27.8600,1000,27.7200,27.8400,27,0
SDP,27,300,18.4700,44,18.3000,18.3500,27,0
AMH-H,26,100,26.9700,100,26.5500,26.9000,0,26
SPLP,26,100,13.6100,100,13.4500,13.6800,0,26
AKO.B,25,100,17.4200,100,16.6800,17.0000,25,0
CLTL,25,4900,105.6900,29900,105.6700,105.6800,25,0
HCAP,25,1100,7.7300,100,7.6600,7.8000,25,0
JHMC,25,100,48.9700,300,48.5400,48.7900,25,0
JKF,25,300,115.1500,300,115.1100,115.3700,25,0
UST,25,500,71.7700,500,71.6500,71.7300,25,0
CAPE,24,400,180.4700,400,179.7400,179.9500,0,24
CND=,24,100,10.7800,600,10.7000,10.7400,24,0
LDEM,24,400,65.9200,400,65.6800,65.8400,24,0
RESE,24,600,39.0500,600,38.9000,38.9000,24,0
ACSI,23,3500,44.8000,3500,44.7500,44.6300,23,0
BRK.A,23,1,353450.5000,1,353107.0000,353201.0000,22,1
DFVL,23,100,84.5400,100,83.7000,83.0300,23,0
IVOG,23,100,192.2800,100,192.0700,192.2300,23,0
BRPAU,22,100,51.2000,100,36.3600,54.5000,2,20
ELC,22,100,26.5400,100,26.1900,26.4300,22,0
FLEH,22,200,24.7800,200,24.6900,24.7600,22,0
TERM,22,100,19.1800,400,19.1100,19.1500,22,0
FCRZ,21,200,26.6300,200,23.9600,25.3000,21,0
CSB,20,400,52.7400,100,52.6100,52.4700,20,0
CSD,20,300,59.6700,100,59.0400,60.5400,0,20
GRNVU,20,100,12.3400,100,11.4600,11.9000,20,0
KCCB,20,100,39.6000,100,39.3900,39.2800,20,0
KWT,20,100,28.2000,100,28.0600,28.1800,20,0
MOM,20,100,25.5500,1000,25.1100,25.1900,0,20
OPHC,20,100,3.5800,100,3.3200,3.4700,20,0
SGDJ,20,100,47.3100,100,46.9700,47.7000,0,20
UBCP,20,100,14.2500,100,13.8600,13.8200,20,0
XPP,20,10,90.8900,10,90.6900,90.4900,20,0
AMCIU,19,100,20.9400,100,18.6800,19.8050,19,0
ARKR,19,100,19.9700,100,19.6100,19.4700,19,0
CIX,19,17,14.5400,100,14.3900,14.3000,18,1
DBAW,19,1000,32.0600,1100,31.8500,32.1700,19,0
OFED,19,5,24.3400,100,20.8400,22.5000,19,0
UMDD,19,10,122.1800,10,121.9200,121.4900,19,0
AIEQ,18,400,39.4400,400,39.1900,39.3600,18,0
CBAN,18,100,14.4000,100,13.9100,14.1100,18,0
COMB,18,400,24.0800,400,23.9900,24.0100,0,18
INKM,18,500,34.3000,500,34.2500,34.2500,18,0
INSE,18,100,6.3100,100,6.1900,6.2550,18,0
SIJ,18,300,9.8100,180,9.7200,9.6900,18,0
WFC-R,18,100,28.8700,100,28.7000,28.7000,18,0
WWOW,18,500,28.7100,3,27.4900,27.4000,13,5
FRC-I,17,100,27.3800,100,27.0100,27.2600,17,0
OVF,17,100,26.3900,100,26.0800,26.2400,17,0
DWX,16,300,37.2600,700,37.1700,37.1700,16,0
FAB,16,1100,62.0100,200,61.8700,62.0000,16,0
PSA-K,16,100,27.4600,100,27.1500,27.2300,16,0
USDU,16,100,25.1800,100,25.0300,25.2000,16,0
DJCO,15,100,331.3200,100,322.7000,326.9900,14,1
EURL,15,28,28.4500,27,28.3100,28.3100,15,0
PSMC,15,902,13.5600,500,13.5200,13.5400,15,0
PST,14,2200,15.8600,5300,15.8500,15.8550,14,0
BXS-A,13,100,26.5500,100,26.3600,26.4500,13,0
HPKEW,13,100,6.8100,100,6.3500,5.8100,13,0
JJN,13,100,73.2900,200,71.5200,71.8100,13,0
PSA-G,13,100,26.6600,100,26.2500,26.4700,13,0
PSA-J,13,100,26.7800,100,26.4900,26.6700,13,0
QADB,13,100,53.2100,100,49.5500,49.7500,13,0
GRNB,12,300,27.8100,300,27.7400,27.8100,12,0
ACKIU,11,100,10.5500,100,10.4900,10.5000,11,0
COW,11,100,34.7800,300,34.5700,34.0100,11,0
FRI,11,1200,23.4400,2000,23.3200,23.5300,1,10
LIVE,11,100,20.3600,100,19.5000,19.7500,10,1
PWOD,11,100,22.8800,100,22.6800,22.8200,9,2
SAA,11,10,127.9100,10,127.4900,128.6200,11,0
SBOW,11,100,5.8600,102,5.7600,5.8400,11,0
USVM,11,300,65.2800,200,65.1800,65.0900,11,0
ADFI,10,500,9.9100,1,9.9000,9.9100,10,0
CHII,10,100,16.9100,100,16.5700,16.7700,10,0
DIT,10,10,120.5700,10,112.5300,112.6400,10,0
FAT,10,100,6.4700,300,6.3700,6.4000,10,0
FRLG,10,100,252.5500,100,249.7300,250.0000,10,0
IBMO,10,300,27.1200,9300,27.0500,27.1200,10,0
MMTM,10,1000,166.3800,1000,166.2300,164.4700,10,0
OPT,10,100,12.6200,45,12.1200,12.1200,10,0
PEI-C,10,100,12.4800,100,12.2100,12.2400,10,0
SEB,10,1,3145.4800,1,3110.3100,3127.0000,10,0
SOAC=,10,400,12.8000,900,12.6200,12.8000,10,0
ZTR,10,200,8.7900,1200,8.7600,8.7500,10,0
FOVL,9,300,46.1100,300,46.0500,46.1000,9,0
FRAF,9,100,28.4900,100,27.8300,28.0000,3,6
HYMCZ,9,100,0.5300,100,0.4300,0.4600,9,0
IVLC,9,500,12.3700,500,12.3600,12.4200,9,0
OVLH,9,200,26.6200,200,24.0300,25.3500,9,0
RAAX,9,500,23.1700,100,23.0400,23.1600,9,0
SPXT,9,500,66.4100,500,66.1700,66.7000,9,0
FLCB,8,2025,26.0000,100,25.9500,26.0100,8,0
IRCP,8,100,9.3900,100,9.2200,9.4300,8,0
LDSF,8,400,20.4800,80,20.4400,20.4700,8,0
LGLV,8,100,119.8400,850,119.8000,119.8800,8,0
EQRR,7,100,41.1800,100,40.8300,41.0200,7,0
FGD,7,1300,23.3200,600,23.2500,23.2600,7,0
HNNA,7,100,8.8100,100,8.6000,8.7200,7,0
MOR,7,100,30.2100,100,29.8000,29.8400,7,0
NYC,7,100,9.9900,100,9.6700,9.6200,7,0
PEBK,7,6,23.3400,100,21.4500,23.0900,7,0
RILYN,7,123,25.6100,100,25.4600,25.6450,7,0
VPOP,7,2500,13.2500,2600,13.0500,13.1700,7,0
BUL,6,700,35.2600,700,35.1800,35.2000,6,0
BWG,6,61,12.3600,100,12.3100,12.3300,6,0
CDL,6,1100,48.8300,1100,48.7500,48.7400,6,0
CHIS,6,100,36.2100,100,35.6900,35.9900,6,0
DHR-A,6,100,1595.0700,100,1592.3600,1604.2200,6,0
EAI,6,100,25.9600,100,25.7300,25.9400,6,0
EFF,6,100,15.7400,100,15.5600,15.6500,6,0
FRAK,6,300,88.7000,300,87.2100,92.2100,6,0
JHMF,6,100,42.8000,200,42.5600,42.7200,0,6
MUH,6,100,15.3700,100,15.2000,15.2000,6,0
PSMM,6,500,14.7900,800,14.7400,14.8500,6,0
VLU,6,1000,127.9600,1100,127.6100,127.6000,6,0
AHC,5,98,1.9400,3,1.9200,1.9400,5,0
ANDA,5,100,11.5400,100,11.3600,11.5500,5,0
BNE,5,100,33.3600,100,32.7400,32.9650,5,0
EWV,5,758,13.9900,758,13.9600,13.9500,5,0
FUT,5,300,40.8400,300,40.6800,40.9000,5,0
GAL,5,2000,43.8100,2500,43.7000,43.7500,5,0
GSID,5,100,54.2100,100,53.9500,54.0700,5,0
GSUM,5,700,1.7800,65,1.7400,1.7600,5,0
HYB,5,100,8.9600,100,8.8800,8.9400,5,0
KFFB,5,100,6.4400,100,6.2900,6.3600,5,0
LYFE,5,1800,27.2200,2200,27.2000,27.1800,5,0
MDRRP,5,200,22.0300,200,18.6000,20.8900,5,0
OPP,5,105,14.4500,100,14.3800,14.4300,5,0
QDEF,5,1900,49.2600,300,49.2400,49.1200,5,0
RNEM,5,100,48.6100,100,48.4000,48.2900,5,0
RWVG,5,100,50.8700,100,50.6000,50.8400,5,0
SPDV,5,167,25.8800,200,25.8100,25.8000,5,0
TDVG,5,2000,28.6300,2000,28.6200,28.6500,5,0
USB-A,5,100,953.6900,100,927.0000,932.6900,5,0
VWID,5,1000,28.0300,1000,28.0000,28.0800,5,0
ASLE,4,200,15.5000,100,15.2100,15.3600,4,0
ESGN,4,500,26.3400,300,26.0900,26.2150,4,0
FTSD,4,100,96.2800,100,95.4200,95.8100,0,4
GTIM,4,100,3.0300,300,2.9300,2.9900,4,0
JHMI,4,2500,45.6800,2500,45.6200,45.6600,4,0
KRBP,4,100,9.5500,100,9.3700,9.2300,4,0
QLVD,4,100,27.0100,100,26.9700,26.9850,4,0
RBCN,4,100,9.9500,100,9.7700,9.8100,4,0
SYF-A,4,100,26.4800,100,26.2700,26.5000,0,4
XAN-C,4,100,21.5400,100,21.1800,21.3300,4,0
AUBN,3,200,40.3100,100,39.0400,40.2600,3,0
DOCT,3,400,31.2100,200,31.0400,31.1900,3,0
EMTY,3,700,20.3500,600,20.1900,20.3800,3,0
EVX,3,100,125.5400,100,123.9100,137.3000,3,0
FID,3,100,16.9400,100,16.8800,16.9800,3,0
FTLB,3,1000,20.5200,1000,20.4100,20.4550,3,0
HMCOU,3,100,12.3900,100,12.2200,12.3000,3,0
IHE,3,200,183.8100,200,183.6800,183.8100,3,0
LOAN,3,100,5.2300,100,5.1100,5.1500,3,0
LSLT,3,800,28.6400,1000,28.6200,28.8300,3,0
STL-A,3,100,26.3800,100,25.9700,26.1750,3,0
STMB,3,1000,38.8500,1000,38.8200,38.8500,3,0
VSL,3,100,39.2700,100,38.8300,39.0600,3,0
ALOT,2,10,10.7000,99,10.4700,10.6800,2,0
BOCT,2,200,30.4600,500,30.3500,30.4750,2,0
CLA=,2,100,15.0900,100,14.5400,14.8700,2,0
DNOV,2,500,33.6300,400,33.4800,33.6700,2,0
DTD,2,200,107.2900,1550,107.2500,107.0000,2,0
DUOT,2,100,5.2300,100,5.1100,5.2600,2,0
EMXF,2,100,46.0200,100,45.5500,45.6800,2,0
GBGR,2,100,24.7800,100,24.5700,24.6500,2,0
GLDI,2,1000,9.5300,1000,9.5200,9.5100,2,0
GSUS,2,2000,53.8700,2000,53.8400,54.0300,2,0
JILL,2,249,3.8500,400,3.7800,3.8400,2,0
LUB,2,100,2.8700,100,2.8200,2.9000,2,0
ROCHU,2,100,23.8900,100,21.0900,21.5000,2,0
SIM,2,100,13.8200,1500,12.1100,12.9900,2,0
SMIT,2,100,5.1100,100,5.0200,5.1000,2,0
STLC,2,800,36.9600,1000,36.9300,37.0900,2,0
TACE,2,1000,25.1700,1000,25.1200,25.1300,2,0
UNB,2,100,26.9300,100,25.9300,26.3000,1,1
VHI,2,100,17.0500,34,16.8000,16.9400,1,1
WIZ,2,200,35.9400,200,35.7700,35.8500,2,0
XVZ,2,300,38.8900,300,38.5500,38.8900,2,0
AGGP,1,100,19.9300,900,19.8800,19.7800,1,0
ANH-B,1,100,24.4400,100,23.9800,24.1700,1,0
BBP,1,100,56.6000,100,56.1700,56.6400,1,0
BDL,1,100,24.0900,100,22.5500,26.5000,1,0
BOE,1,100,11.0700,100,11.0100,11.0800,1,0
BSMP,1,300,26.0100,100,25.9200,26.0000,1,0
BWZ,1,700,32.8100,600,32.6100,32.7400,1,0
CCRV,1,199,21.9800,100,21.9400,21.9600,1,0
CEZ,1,100,28.1000,500,28.0200,28.0200,1,0
CFCV,1,3200,30.9400,800,30.8600,31.2600,1,0
CHSCM,1,100,28.0400,100,27.8200,27.8900,1,0
CHSCO,1,100,28.8200,100,28.4400,28.6000,1,0
CIL,1,500,42.6600,500,42.5200,42.4600,1,0
DECZ,1,1000,26.0100,1000,25.9100,25.8800,1,0
DRW,1,300,26.1000,900,25.8400,26.1600,1,0
DSOC,1,100,28.6300,100,28.4900,28.5200,1,0
EAOK,1,300,27.3300,400,27.3000,27.2900,1,0
EAOM,1,300,28.1400,400,28.1100,28.1700,1,0
EAST,1,300,1.5300,300,1.4900,1.4600,1,0
ENTR,1,100,28.8500,100,28.5700,28.7900,1,0
ESHY,1,1000,21.3500,3,21.2400,21.7000,1,0
EWSC,1,1600,71.2800,100,70.8200,71.5200,1,0
FCOM,1,700,46.8400,200,46.8100,46.8000,1,0
FDMO,1,600,46.6400,600,46.2100,46.2200,1,0
FHN-C,1,100,28.3200,100,27.6000,27.9000,0,1
FLIY,1,100,24.9900,100,24.9600,24.9650,1,0
FLM,1,600,52.6500,100,52.0100,51.7800,1,0
FVC,1,17,33.1700,5017,33.0800,33.0200,1,0
GBUG,1,3100,30.6200,3100,30.6100,30.6200,1,0
GCBC,1,100,25.7700,100,25.0100,25.6100,1,0
GHG,1,100,13.2000,100,12.9800,13.1200,0,1
GLV,1,100,10.7600,100,10.6500,10.6600,0,1
GTN.A,1,100,16.8100,100,14.9800,15.7100,1,0
HDIV,1,700,27.8100,700,27.6500,27.6200,1,0
HYLV,1,99,25.3300,300,25.3200,25.3300,1,0
JKG,1,100,243.3100,100,243.1400,243.4600,1,0
LBTYB,1,100,25.8500,100,24.8400,25.3650,1,0
LFEQ,1,100,35.6200,200,35.4700,35.5500,1,0
LTRPB,1,100,34.6100,100,32.3700,34.0000,1,0
MAACU,1,100,11.0400,100,10.8600,11.0000,1,0
MIG,1,8200,25.1200,500,25.1100,25.1000,1,0
PCSA,1,100,6.8000,200,6.6200,6.9000,1,0
PESI,1,100,6.4700,100,6.2600,6.3950,1,0
REC,1,500,25.3400,100,25.3300,25.3200,1,0
REDU,1,100,5.9400,100,5.8500,5.8300,1,0
RJN,1,200,1.8000,100,1.7300,1.7300,1,0
RMRM,1,100,10.8900,100,10.7600,10.8000,1,0
RNDM,1,100,53.8700,100,53.6400,53.6100,1,0
ROCC,1,100,10.5000,100,10.3900,10.4600,1,0
RODE,1,2000,27.8600,500,27.7500,27.7300,1,0
RODI,1,200,100.2200,200,100.1900,100.1000,1,0
RSXJ,1,200,37.5700,400,37.1400,37.5800,1,0
RVNU,1,200,29.2800,100,29.1400,29.2650,1,0
RYH,1,200,272.2400,200,272.1100,271.6000,0,1
SELF,1,800,4.0200,300,3.9600,4.0000,1,0
SENEB,1,100,38.2800,100,36.9200,40.0800,1,0
SNV-E,1,100,26.9500,40,26.6800,26.7100,1,0
SOHOB,1,100,13.8500,100,13.1900,13.5100,1,0
SOHOO,1,100,13.6600,100,13.2800,13.5000,1,0
SPLP-A,1,52,21.4000,100,21.2300,21.4700,1,0
TGIF,1,500,104.1000,10,103.9600,104.2300,0,1
TOK,1,402,86.0000,100,85.5700,86.0000,1,0
UAE,1,100,13.4300,100,13.2800,13.3600,1,0
UNL,1,100,7.9300,100,7.7900,7.8500,1,0
USSG,1,400,35.0900,100,34.9800,35.1000,1,0
VMM,1,409,13.4100,100,13.1900,13.1200,0,1
WLDR,1,300,24.3000,400,24.0100,24.6100,1,0
AAA,0,500,25.1800,500,25.1200,0.0000,0,0
AADR,0,100,64.7200,200,63.9500,0.0000,0,0
AAIC-B,0,200,24.0400,200,20.3000,0.0000,0,0
AAMC,0,100,21.8600,100,20.6700,0.0000,0,0
ABR-A,0,100,25.8700,100,25.6000,0.0000,0,0
ABR-B,0,100,25.6000,100,25.2000,0.0000,0,0
ABR-C,0,100,25.9800,100,25.7300,0.0000,0,0
ACACW,0,100,2.4100,100,2.2500,0.0000,0,0
ACIC+,0,100,1.9400,100,1.8500,0.0000,0,0
ACND=,0,400,11.5000,500,11.3800,0.0000,0,0
ACSG,0,500,33.0600,500,32.9800,0.0000,0,0
ACTV,0,2000,33.3000,2000,33.2000,0.0000,0,0
ACVF,0,2000,28.5700,100,28.5000,0.0000,0,0
ADILW,0,100,0.5163,100,0.4263,0.0000,0,0
ADOCR,0,200,0.6388,200,0.3152,0.0000,0,0
ADOCW,0,200,0.7600,300,0.6900,0.0000,0,0
AEB,0,100,25.3600,100,25.1300,0.0000,0,0
AEL-A,0,100,26.0900,100,25.7600,0.0000,0,0
AEL-B,0,100,27.2300,100,26.9400,0.0000,0,0
AENZ,0,2,2.3400,100,2.2100,0.0000,0,0
AFC,0,100,26.2300,100,25.9100,0.0000,0,0
AFGD,0,100,27.8500,100,27.6000,0.0000,0,0
AFGE,0,100,27.2200,100,26.9000,0.0000,0,0
AFINP,0,100,25.5100,5,25.2600,0.0000,0,0
AFK,0,100,21.5900,100,21.3200,0.0000,0,0
AFLG,0,800,23.1600,1000,23.1400,0.0000,0,0
AFMC,0,500,22.8800,700,22.8400,0.0000,0,0
AFSM,0,700,24.2300,900,24.1700,0.0000,0,0
AFTY,0,300,24.4800,300,24.3300,0.0000,0,0
AGBA,0,100,10.6300,100,10.5000,0.0000,0,0
AGBAU,0,100,13.2600,100,10.7500,0.0000,0,0
AGD,0,100,10.8600,500,10.8300,0.0000,0,0
AGM-C,0,100,27.0800,100,26.4400,0.0000,0,0
AGM-D,0,100,27.3100,100,27.0000,0.0000,0,0
AGM-E,0,100,27.2500,100,26.6800,0.0000,0,0
AGM-F,0,100,26.7100,100,26.3900,0.0000,0,0
AGM.A,0,103,72.5100,100,66.9000,0.0000,0,0
AGMH,0,100,15.3900,100,14.5300,0.0000,0,0
AGO-B,0,100,26.5800,100,26.2700,0.0000,0,0
AGO-F,0,100,25.6900,100,25.3600,0.0000,0,0
AGZD,0,100,47.5300,100,46.9700,0.0000,0,0
AHACU,0,300,10.8000,200,10.7500,0.0000,0,0
AHACW,0,100,1.5700,100,1.4100,0.0000,0,0
AHL-C,0,100,26.7000,100,26.3100,0.0000,0,0
AHT-D,0,100,15.0600,100,14.5000,0.0000,0,0
AHT-F,0,100,14.2600,100,13.7500,0.0000,0,0
AHT-H,0,100,14.2100,100,13.9000,0.0000,0,0
AHT-I,0,100,14.1600,100,13.9600,0.0000,0,0
AIC,0,100,24.9300,100,24.4100,0.0000,0,0
AIIQ,0,400,32.5600,100,32.3300,0.0000,0,0
AIRTP,0,100,26.5700,100,25.1000,0.0000,0,0
AIRTW,0,100,0.1955,100,0.1326,0.0000,0,0
AIW,0,100,24.9400,100,24.7100,0.0000,0,0
AKO.A,0,100,14.3500,100,13.8100,0.0000,0,0
ALACU,0,100,19.5500,100,15.8600,0.0000,0,0
ALL-G,0,100,27.8500,100,27.5400,0.0000,0,0
ALL-I,0,100,26.8500,100,26.5800,0.0000,0,0
ALP-Q,0,100,27.8100,100,27.4100,0.0000,0,0
ALTG+,0,100,2.5400,100,2.4000,0.0000,0,0
ALTG-A,0,100,26.3200,100,26.0500,0.0000,0,0
ALTL,0,300,34.2800,400,34.2400,0.0000,0,0
ALUS+,0,100,1.7800,200,1.6900,0.0000,0,0
ALUS=,0,400,11.4200,400,11.2700,0.0000,0,0
AMBC+,0,100,5.0900,100,4.7700,0.0000,0,0
AMCA,0,200,32.6700,100,32.6200,0.0000,0,0
AMH-D,0,100,25.4900,100,25.2700,0.0000,0,0
AMH-G,0,100,26.0800,100,25.6500,0.0000,0,0
AMHC,0,200,10.3500,100,10.2700,0.0000,0,0
AMHCU,0,100,11.0400,100,10.6600,0.0000,0,0
AMNA,0,100,27.6400,100,27.4000,0.0000,0,0
AMND,0,100,29.1900,100,28.9600,0.0000,0,0
AMOM,0,200,33.2900,200,33.2100,0.0000,0,0
AMOV,0,100,15.5400,100,14.9900,0.0000,0,0
AMST,0,100,4.4400,17,4.3600,0.0000,0,0
AMTR,0,100,31.7300,100,31.4800,0.0000,0,0
ANDAU,0,100,12.8100,100,10.9700,0.0000,0,0
ANDAW,0,100,0.9300,100,0.8600,0.0000,0,0
ANH-A,0,100,25.3000,100,24.9300,0.0000,0,0
ANH-C,0,600,24.5000,100,24.2900,0.0000,0,0
AP+,0,100,1.4000,100,0.7560,0.0000,0,0
APO-A,0,100,26.4900,100,26.3000,0.0000,0,0
APO-B,0,100,27.0300,100,26.7700,0.0000,0,0
APOPW,0,300,0.3072,300,0.1591,0.0000,0,0
APXTU,0,400,17.8400,900,17.5500,0.0000,0,0
ARB,0,3500,25.4200,600,25.3700,0.0000,0,0
ARES-A,0,100,25.8900,100,25.6200,0.0000,0,0
ARGO-A,0,100,26.9500,100,26.7300,0.0000,0,0
ARMP,0,100,3.4300,100,3.3400,0.0000,0,0
ARMR,0,1000,22.5400,1000,22.3700,0.0000,0,0
ARTLW,0,300,0.3968,300,0.2116,0.0000,0,0
ARTW,0,100,3.0000,271,2.9400,0.0000,0,0
ARYA,0,100,11.5400,100,11.4000,0.0000,0,0
ASAQ+,0,100,1.4900,100,1.3900,0.0000,0,0
ASAQ=,0,400,11.0000,400,10.9000,0.0000,0,0
ASB-C,0,100,26.1500,100,25.7500,0.0000,0,0
ASB-D,0,100,25.8900,100,25.5300,0.0000,0,0
ASET,0,100,30.5200,100,30.3700,0.0000,0,0
ASHX,0,200,32.0700,100,31.6700,0.0000,0,0
ASPL+,0,100,1.5500,100,1.3800,0.0000,0,0
ASPL=,0,100,10.7500,900,10.6500,0.0000,0,0
ASRVP,0,100,30.0600,100,27.9000,0.0000,0,0
ATA=,0,100,10.6200,100,10.4600,0.0000,0,0
ATCO-D,0,100,25.5300,100,25.3000,0.0000,0,0
ATCO-E,0,100,25.8300,100,25.5200,0.0000,0,0
ATCO-H,0,100,25.6300,100,25.4100,0.0000,0,0
AUBAP,0,100,27.1900,100,26.8500,0.0000,0,0
AUSF,0,500,26.6800,500,26.5900,0.0000,0,0
AVEM,0,100,67.2500,100,66.6300,0.0000,0,0
AVMU,0,300,50.2200,300,50.1500,0.0000,0,0
AVSF,0,1000,50.2000,1000,50.1600,0.0000,0,0
AWRE,0,100,4.3300,100,4.2400,0.0000,0,0
AWTM,0,10000,50.0300,10000,49.9200,0.0000,0,0
AXO,0,100,25.8000,100,25.3500,0.0000,0,0
AXS-E,0,100,25.8900,100,25.6500,0.0000,0,0
AZAL,0,100,27.0500,100,26.8000,0.0000,0,0
AZAO,0,100,27.2000,100,26.9500,0.0000,0,0
AZBA,0,200,25.7700,300,25.5400,0.0000,0,0
AZBO,0,100,26.2400,100,26.0700,0.0000,0,0
BAC-E,0,100,25.3800,100,25.0800,0.0000,0,0
BAF,0,35,15.3000,100,15.1100,0.0000,0,0
BAL,0,100,47.8700,100,47.1900,0.0000,0,0
BANC-D,0,100,25.5500,100,25.3200,0.0000,0,0
BANC-E,0,100,25.5400,100,25.2600,0.0000,0,0
BANFP,0,100,28.8700,100,28.0900,0.0000,0,0
BANX,0,600,20.0000,100,19.8300,0.0000,0,0
BATL,0,100,8.2100,100,7.8100,0.0000,0,0
BBC,0,100,53.3700,500,52.9300,0.0000,0,0
BBMC,0,500,84.3800,100,84.0200,0.0000,0,0
BBN,0,100,26.1100,100,25.8500,0.0000,0,0
BBSC,0,100,62.7100,100,62.1800,0.0000,0,0
BC-A,0,100,26.9200,100,26.5800,0.0000,0,0
BC-C,0,100,27.4400,100,26.9200,0.0000,0,0
BCDAW,0,200,1.8900,200,1.6200,0.0000,0,0
BCM,0,200,31.0600,200,30.8300,0.0000,0,0
BCOW,0,100,10.1900,100,9.7000,0.0000,0,0
BCTG,0,100,11.4300,100,11.3100,0.0000,0,0
BCV-A,0,100,25.9900,100,25.7000,0.0000,0,0
BDCX,0,200,32.2200,100,30.5200,0.0000,0,0
BDCZ,0,100,16.6200,300,16.5300,0.0000,0,0
BELFA,0,100,15.3800,100,14.5000,0.0000,0,0
BFOR,0,600,52.9400,500,52.7800,0.0000,0,0
BFS-D,0,100,24.3300,100,24.0200,0.0000,0,0
BFS-E,0,100,23.4200,100,23.1600,0.0000,0,0
BGIO,0,100,9.1500,100,9.0700,0.0000,0,0
BH.A,0,10,553.7800,10,532.8600,0.0000,0,0
BHFAP,0,100,27.4200,100,27.0500,0.0000,0,0
BHR-D,0,100,20.0400,100,19.4300,0.0000,0,0
BHSEU,0,100,11.4900,200,11.0700,0.0000,0,0
BHSEW,0,200,1.2800,100,1.1600,0.0000,0,0
BHV,0,310,16.1900,100,15.8900,0.0000,0,0
BICK,0,100,40.8100,200,40.6000,0.0000,0,0
BILS,0,5000,100.1000,5000,100.0500,0.0000,0,0
BIO.B,0,95,591.3300,100,586.5500,0.0000,0,0
BIP-A,0,100,25.7900,100,25.5500,0.0000,0,0
BJUN,0,400,31.4600,200,31.3000,0.0000,0,0
BKEM,0,100,79.9800,100,79.2900,0.0000,0,0
BKEPP,0,100,7.0800,100,6.9600,0.0000,0,0
BKHY,0,100,56.6500,100,56.1500,0.0000,0,0
BKIE,0,100,69.5500,100,69.0100,0.0000,0,0
BKLC,0,100,73.4800,100,72.8800,0.0000,0,0
BKMC,0,100,81.3300,100,80.9000,0.0000,0,0
BKSB,0,100,51.8700,100,51.4500,0.0000,0,0
BKSC,0,100,16.6600,100,16.2900,0.0000,0,0
BKSE,0,100,90.6300,100,90.0800,0.0000,0,0
BKTI,0,100,3.5000,100,3.4100,0.0000,0,0
BLE,0,100,15.5600,100,15.4200,0.0000,0,0
BLES,0,300,34.9800,200,34.5400,0.0000,0,0
BLHY,0,100,24.6900,100,24.2600,0.0000,0,0
BLSA,0,100,11.2800,100,10.9600,0.0000,0,0
BMAY,0,1000,29.8500,3335,29.8100,0.0000,0,0
BNOV,0,300,30.1600,300,30.0700,0.0000,0,0
BOKFL,0,100,25.7900,100,25.3700,0.0000,0,0
BOSC,0,100,2.5900,300,2.5100,0.0000,0,0
BOTJ,0,100,13.1900,100,12.7400,0.0000,0,0
BPOPM,0,100,25.7400,100,25.4800,0.0000,0,0
BPOPN,0,100,25.8200,100,25.5000,0.0000,0,0
BPYPN,0,100,23.1900,100,23.0400,0.0000,0,0
BRF,0,300,20.6800,200,20.4800,0.0000,0,0
BRG-A,0,100,25.3600,100,25.1500,0.0000,0,0
BRG-C,0,100,25.9900,100,25.5400,0.0000,0,0
BRG-D,0,100,25.6000,100,25.2800,0.0000,0,0
BRLIR,0,200,0.5504,200,0.2952,0.0000,0,0
BRLIU,0,100,12.6300,100,10.2400,0.0000,0,0
BRMK+,0,100,0.3004,100,0.2340,0.0000,0,0
BROG,0,100,10.9400,100,10.4400,0.0000,0,0
BROGW,0,300,0.8500,100,0.7500,0.0000,0,0
BSA,0,100,25.2400,100,24.9400,0.0000,0,0
BSAE,0,300,25.3000,300,25.1300,0.0000,0,0
BSBE,0,100,25.9400,100,25.7700,0.0000,0,0
BSCE,0,100,26.4200,100,26.2600,0.0000,0,0
BSD,0,100,15.0400,100,14.7400,0.0000,0,0
BSDE,0,100,26.3100,100,26.1600,0.0000,0,0
BSE,0,200,13.7600,100,13.6500,0.0000,0,0
BSJS,0,100,25.7500,100,25.4700,0.0000,0,0
BSMM,0,300,25.4700,100,25.3600,0.0000,0,0
BSMN,0,300,25.6600,100,25.5500,0.0000,0,0
BSMO,0,300,25.7900,100,25.6900,0.0000,0,0
BSMQ,0,100,25.9500,300,25.8500,0.0000,0,0
BSMR,0,100,25.8400,100,25.7400,0.0000,0,0
BSMS,0,100,26.2000,100,26.1000,0.0000,0,0
BSN=,0,400,11.0200,400,10.9300,0.0000,0,0
BWACU,0,100,12.0800,100,11.8200,0.0000,0,0
BWACW,0,100,1.7000,200,1.6300,0.0000,0,0
BWL.A,0,100,9.7300,100,9.5100,0.0000,0,0
BZM,0,100,15.7500,100,15.2700,0.0000,0,0
CAF,0,27,22.4700,100,22.3600,0.0000,0,0
CAI-A,0,100,25.9800,100,25.4500,0.0000,0,0
CAI-B,0,100,26.5400,100,25.6700,0.0000,0,0
CALT,0,100,32.8200,100,31.4500,0.0000,0,0
CAPA,0,1,10.7900,98,10.3000,0.0000,0,0
CAPAU,0,100,10.7900,100,10.5600,0.0000,0,0
CAPAW,0,100,1.7800,100,1.5800,0.0000,0,0
CBAH=,0,100,10.9000,100,10.6600,0.0000,0,0
CBB-B,0,100,50.1400,100,49.4100,0.0000,0,0
CBLS,0,1000,25.1400,1000,25.1100,0.0000,0,0
CBMB,0,100,14.0500,100,13.7000,0.0000,0,0
CCON,0,100,63.7100,100,63.3900,0.0000,0,0
CCOR,0,500,28.3000,500,28.1900,0.0000,0,0
CCX+,0,100,2.3300,100,2.2300,0.0000,0,0
CCX=,0,400,11.6300,400,11.4000,0.0000,0,0
CCZ,0,200,78.7300,200,56.6500,0.0000,0,0
CDMOP,0,100,29.5100,100,29.1600,0.0000,0,0
CDR-B,0,100,24.6000,100,24.4500,0.0000,0,0
CEFD,0,100,29.5100,100,29.2600,0.0000,0,0
CELG^,0,100,0.4140,100,0.2992,0.0000,0,0
CELP,0,500,2.9000,100,2.7700,0.0000,0,0
CETXP,0,5,2.1500,200,2.0200,0.0000,0,0
CETXW,0,200,0.1388,200,0.0720,0.0000,0,0
CEV,0,100,13.6800,100,13.5200,0.0000,0,0
CEW,0,100,18.5000,800,18.2900,0.0000,0,0
CFACW,0,166,2.8700,200,2.5800,0.0000,0,0
CFBK,0,100,17.5700,100,16.9100,0.0000,0,0
CGROU,0,100,16.4700,100,15.5100,0.0000,0,0
CHAD,0,3700,16.2900,1200,16.2700,0.0000,0,0
CHAQ+,0,100,1.2000,100,1.1000,0.0000,0,0
CHAQ=,0,100,13.5800,100,11.0700,0.0000,0,0
CHEKZ,0,100,0.3684,100,0.3079,0.0000,0,0
CHFW=,0,100,11.0300,500,10.8000,0.0000,0,0
CHIC,0,100,30.4000,400,29.8900,0.0000,0,0
CHIE,0,100,9.2600,100,9.0500,0.0000,0,0
CHIH,0,100,30.7600,100,30.3300,0.0000,0,0
CHIL,0,100,43.8400,100,43.4300,0.0000,0,0
CHIM,0,100,24.9700,100,24.5100,0.0000,0,0
CHIR,0,100,17.2500,100,17.0900,0.0000,0,0
CHIU,0,100,16.3200,100,15.9300,0.0000,0,0
CHMI-A,0,100,25.4300,100,25.1000,0.0000,0,0
CHMI-B,0,100,23.4900,100,23.1600,0.0000,0,0
CHNGU,0,200,81.5700,200,81.2100,0.0000,0,0
CHPMU,0,100,11.0400,100,10.7600,0.0000,0,0
CHSCN,0,100,28.1200,100,27.6800,0.0000,0,0
CHSCP,0,100,29.8900,100,29.5700,0.0000,0,0
CIF,0,100,2.5100,100,2.4600,0.0000,0,0
CIH,0,100,2.1400,103,2.0600,0.0000,0,0
CIICU,0,400,33.5000,900,32.8000,0.0000,0,0
CIM-C,0,100,23.4800,100,23.2100,0.0000,0,0
CIO-A,0,100,25.4800,100,25.0100,0.0000,0,0
CIZ,0,500,32.4300,500,32.3100,0.0000,0,0
CKX,0,100,10.4500,100,10.0200,0.0000,0,0
CLDL,0,200,27.2500,200,24.4200,0.0000,0,0
CLDS,0,200,25.2900,200,22.7800,0.0000,0,0
CLNNW,0,200,0.7100,212,0.6700,0.0000,0,0
CLNY-G,0,100,24.0600,100,23.8400,0.0000,0,0
CLNY-H,0,100,23.7600,100,23.5100,0.0000,0,0
CLNY-J,0,100,23.8200,100,23.4600,0.0000,0,0
CLRG,0,300,30.0300,300,29.7700,0.0000,0,0
CLRO,0,100,2.4800,300,2.4500,0.0000,0,0
CMCTP,0,100,23.5900,100,22.7600,0.0000,0,0
CMDY,0,100,46.8000,100,46.5300,0.0000,0,0
CMFNL,0,100,24.8400,100,24.5100,0.0000,0,0
CMLFW,0,112,3.0500,100,2.9600,0.0000,0,0
CMO-E,0,100,25.0700,100,24.8400,0.0000,0,0
CMRE-B,0,100,25.0800,100,24.8800,0.0000,0,0
CMRE-D,0,100,25.7000,100,25.4000,0.0000,0,0
CMRE-E,0,100,26.0000,100,25.7000,0.0000,0,0
CMS-B,0,10,110.8900,10,108.8700,0.0000,0,0
CMSA,0,100,27.0000,100,26.6700,0.0000,0,0
CMT,0,100,13.8200,100,13.6600,0.0000,0,0
CN,0,200,50.0100,200,49.7800,0.0000,0,0
CNCR,0,500,34.7800,100,34.1200,0.0000,0,0
CNFRL,0,100,24.5900,100,23.9100,0.0000,0,0
CNNB,0,100,12.0400,100,11.8400,0.0000,0,0
CODI-A,0,100,25.2700,100,24.9800,0.0000,0,0
CODI-C,0,100,25.1600,100,24.9400,0.0000,0,0
COFS,0,200,29.8800,100,28.0200,0.0000,0,0
COHN,0,200,17.6700,100,17.4500,0.0000,0,0
COWNZ,0,100,25.4600,100,25.2500,0.0000,0,0
CPAH,0,89,3.4000,200,3.3800,0.0000,0,0
CPHC,0,100,13.3500,100,13.0100,0.0000,0,0
CPI,0,100,27.3200,100,27.1700,0.0000,0,0
CPSR,0,100,10.5500,100,10.3800,0.0000,0,0
CPSR+,0,100,1.5400,100,1.4600,0.0000,0,0
CPSR=,0,100,11.4400,900,11.1300,0.0000,0,0
CPTAG,0,100,24.9800,100,24.3500,0.0000,0,0
CPTAL,0,100,24.8400,100,24.5700,0.0000,0,0
CREXW,0,200,0.3578,200,0.1584,0.0000,0,0
CROC,0,100,43.6600,100,43.2000,0.0000,0,0
CRSAU,0,100,12.9800,100,11.7400,0.0000,0,0
CRT,0,100,8.2800,100,8.2000,0.0000,0,0
CRTDW,0,100,2.3200,100,2.1800,0.0000,0,0
CSA,0,100,57.8500,500,57.7000,0.0000,0,0
CSF,0,700,53.9800,700,53.8800,0.0000,0,0
CSML,0,200,31.6300,600,31.5200,0.0000,0,0
CSR-C,0,100,25.9500,100,25.5900,0.0000,0,0
CSSEN,0,100,25.7900,100,25.5000,0.0000,0,0
CSSEP,0,100,25.5400,100,25.1500,0.0000,0,0
CTA-A,0,100,87.5000,100,84.6700,0.0000,0,0
CTA-B,0,100,115.3200,100,108.0700,0.0000,0,0
CTAA,0,100,25.6300,100,25.4100,0.0000,0,0
CUBB,0,100,25.5500,100,25.1600,0.0000,0,0
CUBI-C,0,100,25.1700,100,24.7600,0.0000,0,0
CUBI-D,0,100,25.0700,100,24.6100,0.0000,0,0
CUBI-E,0,100,24.8300,100,24.5800,0.0000,0,0
CUBI-F,0,100,24.9300,100,24.5600,0.0000,0,0
CUT,0,100,35.0000,100,34.8100,0.0000,0,0
CVE+,0,100,3.6700,100,2.7700,0.0000,0,0
CVR,0,100,23.6400,100,23.0100,0.0000,0,0
CVV,0,100,4.9600,100,4.7800,0.0000,0,0
CWBC,0,100,9.0100,400,8.8000,0.0000,0,0
CXE,0,100,5.1400,1,5.0800,0.0000,0,0
CYAD,0,100,8.7700,100,8.4400,0.0000,0,0
CYB,0,100,27.6200,100,27.4400,0.0000,0,0
CYCCP,0,200,10.0900,200,7.9800,0.0000,0,0
CYD,0,100,17.8700,100,17.5400,0.0000,0,0
DBDRU,0,100,11.1900,1,10.8100,0.0000,0,0
DBEH,0,100,32.7700,100,32.4300,0.0000,0,0
DBEM,0,100,30.0600,100,29.8200,0.0000,0,0
DBGR,0,100,29.8700,100,29.6000,0.0000,0,0
DBJP,0,100,47.1800,200,46.9900,0.0000,0,0
DBLV,0,300,83.9700,300,82.8400,0.0000,0,0
DBMF,0,100,26.5200,100,26.3100,0.0000,0,0
DBP,0,500,51.7100,500,51.5900,0.0000,0,0
DBS,0,100,36.7100,100,36.3800,0.0000,0,0
DBV,0,300,24.4000,100,24.2500,0.0000,0,0
DCOMP,0,100,25.8500,100,25.4000,0.0000,0,0
DCP-B,0,100,22.9000,100,22.3300,0.0000,0,0
DCRBU,0,100,14.3000,100,13.5100,0.0000,0,0
DDMXU,0,100,10.7400,100,10.6600,0.0000,0,0
DDT,0,100,25.4700,400,25.2600,0.0000,0,0
DEED,0,100,25.9800,200,25.7100,0.0000,0,0
DEEP,0,100,30.0000,800,29.8900,0.0000,0,0
DEFN,0,1500,24.9700,500,24.8700,0.0000,0,0
DEUS,0,500,40.1000,5030,39.9300,0.0000,0,0
DEW,0,100,44.0500,100,43.8400,0.0000,0,0
DEX,0,100,9.8500,100,9.7700,0.0000,0,0
DFE,0,600,67.1900,200,66.9000,0.0000,0,0
DFHTW,0,100,4.6400,100,4.2200,0.0000,0,0
DFNL,0,1400,24.9500,1500,24.7900,0.0000,0,0
DFNS=,0,100,12.7100,100,11.7400,0.0000,0,0
DFPH,0,100,11.3500,100,10.9600,0.0000,0,0
DFPHU,0,100,12.5500,100,11.2100,0.0000,0,0
DFVS,0,100,13.9500,100,13.8000,0.0000,0,0
DGICB,0,100,12.8200,100,11.9700,0.0000,0,0
DGNR=,0,100,16.1300,100,14.9700,0.0000,0,0
DGRE,0,200,30.7200,300,30.5400,0.0000,0,0
DGT,0,100,100.8800,100,100.0300,0.0000,0,0
DHR-B,0,100,1354.5600,100,1345.7100,0.0000,0,0
DIM,0,1100,66.0100,500,65.6200,0.0000,0,0
DIVA,0,600,22.2100,600,22.0200,0.0000,0,0
DIVB,0,500,34.3700,600,34.3300,0.0000,0,0
DJCB,0,100,15.1100,100,14.9600,0.0000,0,0
DJUL,0,5000,31.9400,1200,31.7700,0.0000,0,0
DL,0,100,9.6600,100,9.5600,0.0000,0,0
DLNG-A,0,100,24.9000,100,24.5100,0.0000,0,0
DLNG-B,0,100,21.2800,100,20.9200,0.0000,0,0
DLR-L,0,100,26.9600,100,26.7200,0.0000,0,0
DMAY,0,5400,32.9600,5000,32.7800,0.0000,0,0
DMDV,0,100,23.7400,100,23.1900,0.0000,0,0
DMRE,0,400,64.1100,400,63.7900,0.0000,0,0
DMRI,0,100,50.9800,100,50.0300,0.0000,0,0
DMRL,0,16,65.5000,100,65.2300,0.0000,0,0
DMRS,0,100,54.4400,100,53.8000,0.0000,0,0
DMS+,0,100,1.5200,200,1.3700,0.0000,0,0
DMYD=,0,300,21.6600,900,21.2600,0.0000,0,0
DOL,0,1600,47.5000,500,47.1900,0.0000,0,0
DOO,0,600,42.4100,400,42.1400,0.0000,0,0
DRH-A,0,100,26.8000,100,26.5500,0.0000,0,0
DRIOW,0,200,0.2560,200,0.1135,0.0000,0,0
DS-B,0,100,19.5700,100,18.9300,0.0000,0,0
DS-C,0,100,17.5000,500,17.1500,0.0000,0,0
DS-D,0,100,18.0200,100,17.6400,0.0000,0,0
DSJA,0,100,26.1200,100,25.9700,0.0000,0,0
DSKEW,0,100,0.2526,100,0.2084,0.0000,0,0
DSTX,0,400,27.2100,100,26.9700,0.0000,0,0
DSWL,0,100,3.3800,50,3.2500,0.0000,0,0
DTH,0,300,38.8900,300,38.5900,0.0000,0,0
DTLA-,0,100,14.4600,100,13.5700,0.0000,0,0
DTN,0,300,86.0000,2110,85.9600,0.0000,0,0
DTY,0,100,26.5600,100,26.2100,0.0000,0,0
DUKB,0,100,27.9800,100,27.6600,0.0000,0,0
DUKH,0,100,26.1500,100,25.9300,0.0000,0,0
DUSA,0,500,31.0700,500,30.7300,0.0000,0,0
DVOL,0,200,24.9100,500,24.8800,0.0000,0,0
DWAT,0,100,12.7900,2300,12.6300,0.0000,0,0
DWCR,0,100,34.1100,100,33.3500,0.0000,0,0
DWM,0,500,52.4400,200,52.1400,0.0000,0,0
DWMC,0,100,33.4900,2300,33.0600,0.0000,0,0
DWMF,0,400,25.3800,100,25.1500,0.0000,0,0
DWPP,0,500,29.2900,500,29.1300,0.0000,0,0
DX-B,0,100,25.2300,100,25.0200,0.0000,0,0
DXGE,0,100,32.5300,100,32.1200,0.0000,0,0
DXJS,0,300,40.7000,300,40.0200,0.0000,0,0
DXR,0,100,13.1100,100,13.0000,0.0000,0,0
DYHG,0,400,52.9600,400,52.7300,0.0000,0,0
DYNF,0,300,32.9600,300,32.9300,0.0000,0,0
EACPU,0,100,10.4200,100,10.3300,0.0000,0,0
ECCB,0,100,25.3100,100,25.0400,0.0000,0,0
ECCX,0,100,25.1600,100,24.9100,0.0000,0,0
ECCY,0,100,25.3900,100,25.0600,0.0000,0,0
ECF-A,0,200,27.5900,200,24.8100,0.0000,0,0
ECOW,0,100,25.3400,100,25.1000,0.0000,0,0
EDOG,0,200,23.5800,200,23.3400,0.0000,0,0
EDOW,0,8160,27.9400,5510,27.9200,0.0000,0,0
EDTXU,0,100,10.5900,100,10.4900,0.0000,0,0
EEA,0,100,10.6900,200,10.6000,0.0000,0,0
EEH,0,200,28.9100,100,26.9100,0.0000,0,0
EEMS,0,100,55.8300,100,55.0200,0.0000,0,0
EEMX,0,1000,84.6800,1000,84.5300,0.0000,0,0
EFAS,0,100,15.1200,100,15.0300,0.0000,0,0
EFC-A,0,100,23.6800,100,23.3100,0.0000,0,0
EFL,0,100,9.1700,4,9.1200,0.0000,0,0
EGF,0,100,13.3000,100,13.1300,0.0000,0,0
EHT,0,14216,9.8000,3000,9.7800,0.0000,0,0
EIC,0,100,15.2600,100,15.1300,0.0000,0,0
EINC,0,100,44.6600,100,44.3700,0.0000,0,0
EIRL,0,100,51.8200,100,51.2900,0.0000,0,0
EJUL,0,100,26.4700,200,26.4100,0.0000,0,0
EKAR,0,400,40.8500,100,40.5500,0.0000,0,0
ELLO,0,100,33.0100,200,30.5900,0.0000,0,0
EMAG,0,200,21.9800,142,21.4300,0.0000,0,0
EMBD,0,100,27.4100,100,27.3300,0.0000,0,0
EMBH,0,200,23.7600,200,23.6500,0.0000,0,0
EMCB,0,100,77.5700,100,75.9700,0.0000,0,0
EMCF,0,100,29.0700,100,27.1000,0.0000,0,0
EMDV,0,300,60.8100,200,60.5200,0.0000,0,0
EMF,0,100,20.6800,100,20.5200,0.0000,0,0
EMFM,0,100,19.7300,200,19.6400,0.0000,0,0
EMIF,0,500,24.5700,500,24.4400,0.0000,0,0
EMMF,0,400,26.0000,500,25.7600,0.0000,0,0
EMNT,0,900,100.7800,1605,100.7400,0.0000,0,0
EMPW+,0,133,1.3800,100,1.2900,0.0000,0,0
EMSG,0,500,36.2500,500,36.1800,0.0000,0,0
EMSH,0,1,73.4800,246,73.2200,0.0000,0,0
ENBA,0,100,27.0100,100,26.6900,0.0000,0,0
ENJ,0,100,25.9500,100,25.4500,0.0000,0,0
ENPC+,0,100,3.0000,100,2.8400,0.0000,0,0
ENR-A,0,100,98.9600,100,98.0800,0.0000,0,0
ENTXW,0,100,0.2737,100,0.2037,0.0000,0,0
ENX,0,500,12.1800,100,12.1200,0.0000,0,0
EP-C,0,100,50.4500,100,49.8000,0.0000,0,0
EPR-C,0,100,24.0300,100,23.6900,0.0000,0,0
EPU,0,300,35.6000,300,35.3800,0.0000,0,0
EQC-D,0,100,31.9300,100,31.6300,0.0000,0,0
EQD=,0,400,11.3700,1000,11.2600,0.0000,0,0
EQL,0,200,88.8200,1800,88.6500,0.0000,0,0
EQOP,0,500,29.6600,500,29.6300,0.0000,0,0
ERESW,0,100,1.6400,100,1.5400,0.0000,0,0
ERSX,0,100,26.0900,100,25.8600,0.0000,0,0
ERYP,0,100,12.1200,100,11.1500,0.0000,0,0
ESBA,0,100,9.2200,100,9.0900,0.0000,0,0
ESBK,0,100,12.1900,200,11.9500,0.0000,0,0
ESCR,0,1000,22.6600,100,22.4500,0.0000,0,0
ESEB,0,1200,22.2700,1100,22.0700,0.0000,0,0
ESGRO,0,100,27.5700,100,27.1800,0.0000,0,0
ESGS,0,100,31.4300,100,31.0300,0.0000,0,0
ESNG,0,100,59.2700,100,58.7200,0.0000,0,0
ESP,0,100,19.2600,100,18.9000,0.0000,0,0
ESSCU,0,100,12.3800,100,10.0600,0.0000,0,0
ETI-,0,100,27.2300,100,26.7500,0.0000,0,0
ETP-C,0,100,22.1100,100,21.7700,0.0000,0,0
ETP-D,0,100,22.4600,100,22.2200,0.0000,0,0
ETX,0,100,23.2600,100,23.0300,0.0000,0,0
EUCG,0,3800,26.2300,200,26.1300,0.0000,0,0
EUCR,0,100,10.5400,100,10.3600,0.0000,0,0
EUCRU,0,100,10.9200,100,10.5800,0.0000,0,0
EUCRW,0,100,1.7300,100,1.5400,0.0000,0,0
EUDG,0,200,31.3800,200,31.1600,0.0000,0,0
EUDV,0,100,47.3900,10,47.2900,0.0000,0,0
EUFX,0,100,42.3000,100,41.8900,0.0000,0,0
EUSA,0,500,74.8000,4440,74.7000,0.0000,0,0
EUSB,0,824,50.2800,820,50.2600,0.0000,0,0
EUSC,0,1500,32.2000,1500,31.9600,0.0000,0,0
EVG,0,100,13.0500,100,12.9900,0.0000,0,0
EVI,0,100,32.4000,100,31.3900,0.0000,0,0
EWJE,0,100,39.5400,100,39.1900,0.0000,0,0
EWJV,0,100,26.8200,100,26.5800,0.0000,0,0
EWK,0,300,20.3300,700,20.0900,0.0000,0,0
EWMC,0,1600,82.1200,1600,81.6500,0.0000,0,0
EWRE,0,100,29.4800,100,29.3400,0.0000,0,0
EXPCU,0,100,16.6500,100,16.0400,0.0000,0,0
EYESW,0,300,0.3200,300,0.1584,0.0000,0,0
EZJ,0,100,48.7900,16,48.3700,0.0000,0,0
FAM,0,100,10.6400,100,10.5500,0.0000,0,0
FATBP,0,100,16.8800,100,16.6400,0.0000,0,0
FATBW,0,100,4.2400,100,2.7100,0.0000,0,0
FBGX,0,100,584.4700,100,580.3200,0.0000,0,0
FBSS,0,100,19.1500,100,18.9300,0.0000,0,0
FBZ,0,100,12.9200,200,12.6700,0.0000,0,0
FCAL,0,200,54.3800,2,54.1500,0.0000,0,0
FCEF,0,200,23.0700,100,22.9900,0.0000,0,0
FCRW,0,100,25.6100,100,25.1500,0.0000,0,0
FDHY,0,100,55.8700,100,55.3400,0.0000,0,0
FDIV,0,100,48.6900,100,48.2200,0.0000,0,0
FDLO,0,500,43.1300,500,42.8700,0.0000,0,0
FDM,0,700,51.6900,700,51.6500,0.0000,0,0
FDNI,0,100,50.8600,100,50.3400,0.0000,0,0
FDTS,0,100,44.4600,100,43.8600,0.0000,0,0
FDUSG,0,100,25.7000,100,25.4000,0.0000,0,0
FDUSZ,0,100,25.6800,100,25.4000,0.0000,0,0
FEDX,0,100,27.7000,600,27.6500,0.0000,0,0
FEIM,0,100,11.0100,100,10.5100,0.0000,0,0
FEO,0,100,15.2400,100,15.1000,0.0000,0,0
FEUL,0,100,93.8300,100,91.4500,0.0000,0,0
FEUZ,0,100,43.6800,200,43.0900,0.0000,0,0
FEVR,0,100,27.4200,100,27.1700,0.0000,0,0
FFBW,0,100,10.5400,100,10.4100,0.0000,0,0
FFIU,0,100,26.8100,100,26.4900,0.0000,0,0
FFR,0,100,44.1600,100,43.6000,0.0000,0,0
FGFPP,0,200,26.3800,200,22.5800,0.0000,0,0
FGM,0,100,53.3500,400,52.1500,0.0000,0,0
FHN-A,0,100,26.3900,100,25.7500,0.0000,0,0
FHN-B,0,100,27.1600,100,26.7100,0.0000,0,0
FHN-D,0,100,26.5700,100,25.9000,0.0000,0,0
FICS,0,400,31.8300,500,31.5600,0.0000,0,0
FIDI,0,100,19.1400,100,18.9800,0.0000,0,0
FIEE,0,100,167.2200,100,163.1500,0.0000,0,0
FIHD,0,100,194.4300,100,191.0800,0.0000,0,0
FISK,0,100,9.5000,200,8.8200,0.0000,0,0
FISR,0,100,31.8400,900,31.7100,0.0000,0,0
FITBP,0,100,26.8800,100,26.5100,0.0000,0,0
FIVA,0,100,23.1000,100,22.8000,0.0000,0,0
FJNK,0,100,25.5100,100,25.4700,0.0000,0,0
FJP,0,100,53.0200,100,52.5900,0.0000,0,0
FJUL,0,5000,33.3500,6200,33.1800,0.0000,0,0
FJUN,0,33,34.3200,200,34.2000,0.0000,0,0
FKU,0,200,39.5100,100,38.9800,0.0000,0,0
FLACU,0,100,11.4300,200,11.0000,0.0000,0,0
FLAU,0,100,29.5000,100,29.2400,0.0000,0,0
FLAX,0,400,30.7200,100,30.4600,0.0000,0,0
FLBL,0,8200,25.1400,300,25.0600,0.0000,0,0
FLBR,0,200,22.2300,100,22.0500,0.0000,0,0
FLCA,0,100,28.5100,100,28.1800,0.0000,0,0
FLEE,0,200,26.9100,200,26.8600,0.0000,0,0
FLFR,0,200,27.5500,200,27.5200,0.0000,0,0
FLGE,0,100,582.8600,100,577.0800,0.0000,0,0
FLGV,0,200,24.7700,200,24.6700,0.0000,0,0
FLHK,0,100,28.1200,100,28.0400,0.0000,0,0
FLHY,0,7800,26.6700,7850,26.6000,0.0000,0,0
FLIN,0,400,27.6900,369,27.5000,0.0000,0,0
FLJH,0,400,29.0300,100,28.8000,0.0000,0,0
FLKR,0,400,34.0200,200,33.9000,0.0000,0,0
FLLV,0,100,42.7000,100,42.4400,0.0000,0,0
FLMI,0,200,26.5700,200,26.4700,0.0000,0,0
FLMNW,0,100,0.2000,100,0.1752,0.0000,0,0
FLMX,0,400,22.0900,100,21.9000,0.0000,0,0
FLN,0,400,19.2400,700,18.8300,0.0000,0,0
FLQD,0,100,32.3300,300,32.2000,0.0000,0,0
FLQE,0,400,30.9200,400,30.6600,0.0000,0,0
FLQG,0,100,37.3000,100,36.9600,0.0000,0,0
FLQH,0,500,26.1200,500,26.0300,0.0000,0,0
FLQS,0,600,34.0900,600,34.0400,0.0000,0,0
FLRT,0,300,49.3400,300,49.0900,0.0000,0,0
FLRU,0,400,26.3500,100,26.1300,0.0000,0,0
FLSA,0,100,27.2100,100,26.9200,0.0000,0,0
FLSW,0,400,31.4100,100,31.1800,0.0000,0,0
FLTW,0,400,40.8500,400,40.6200,0.0000,0,0
FLUD,0,100,25.1200,100,24.8900,0.0000,0,0
FLYT,0,400,50.2800,400,50.1700,0.0000,0,0
FLZA,0,100,24.4000,100,24.3200,0.0000,0,0
FMBIO,0,100,28.1600,100,27.6400,0.0000,0,0
FMHI,0,200,54.2700,300,53.8500,0.0000,0,0
FMY,0,100,13.5700,100,13.3900,0.0000,0,0
FNB-E,0,100,28.5100,100,27.8000,0.0000,0,0
FNDB,0,200,47.1500,100,47.1100,0.0000,0,0
FNK,0,600,38.0300,2400,37.9800,0.0000,0,0
FORTY,0,200,98.0000,100,91.6400,0.0000,0,0
FPA,0,100,35.4000,400,34.6500,0.0000,0,0
FPXE,0,100,29.9300,100,29.8800,0.0000,0,0
FQAL,0,200,44.0900,500,43.8700,0.0000,0,0
FRD,0,100,7.3400,100,7.1700,0.0000,0,0
FRLN,0,100,18.4500,100,18.0300,0.0000,0,0
FSEA,0,100,9.1800,100,8.8900,0.0000,0,0
FSLF,0,100,14.3300,100,14.1700,0.0000,0,0
FSMB,0,10200,20.8700,200,20.8200,0.0000,0,0
FSRVU,0,100,20.3800,100,19.9300,0.0000,0,0
FST+,0,100,2.0600,100,1.9800,0.0000,0,0
FST=,0,400,11.7200,500,11.5200,0.0000,0,0
FSZ,0,100,62.8700,300,61.9800,0.0000,0,0
FTAG,0,1300,28.5900,100,28.3300,0.0000,0,0
FTAI-A,0,100,23.6700,100,23.3300,0.0000,0,0
FTAI-B,0,100,23.0900,100,22.8100,0.0000,0,0
FTHI,0,1100,20.6100,1000,20.5000,0.0000,0,0
FTLS,0,1000,45.7600,1000,45.4000,0.0000,0,0
FTRI,0,100,12.7600,100,12.6100,0.0000,0,0
FTV-A,0,100,1001.3400,100,995.2300,0.0000,0,0
FTXD,0,200,30.7600,100,30.4400,0.0000,0,0
FTXG,0,100,24.1400,100,23.9400,0.0000,0,0
FTXH,0,100,26.6000,300,26.2700,0.0000,0,0
FTXL,0,100,67.3800,1000,66.7200,0.0000,0,0
FUE,0,100,8.5900,100,8.1700,0.0000,0,0
FUMB,0,400,20.2000,500,20.1400,0.0000,0,0
FUSB,0,1,9.3300,100,9.0600,0.0000,0,0
FWDB,0,200,26.3600,200,26.0200,0.0000,0,0
FXNC,0,100,18.0700,100,17.4300,0.0000,0,0
FXP,0,400,25.8000,32,25.6100,0.0000,0,0
FXU,0,1200,28.2500,3600,28.2300,0.0000,0,0
FYLD,0,300,25.7200,800,25.5400,0.0000,0,0
GAB-G,0,100,25.8300,100,25.4700,0.0000,0,0
GAB-H,0,100,25.7500,100,25.4700,0.0000,0,0
GAB-J,0,100,26.2000,100,25.9200,0.0000,0,0
GAINL,0,100,25.4500,100,25.2400,0.0000,0,0
GAINM,0,100,25.5800,100,25.1200,0.0000,0,0
GAMR,0,500,84.7300,500,83.9400,0.0000,0,0
GAZ,0,100,14.6300,100,14.4700,0.0000,0,0
GBDV,0,100,18.6600,100,18.5000,0.0000,0,0
GBF,0,100,124.8100,100,123.6800,0.0000,0,0
GBIL,0,1800,100.1300,80900,100.1200,0.0000,0,0
GBLIL,0,100,26.6200,100,26.3300,0.0000,0,0
GBLO,0,100,22.1800,100,21.9700,0.0000,0,0
GBNY,0,100,9.5300,100,9.4300,0.0000,0,0
GCOR,0,100,49.7500,100,49.5700,0.0000,0,0
GDL,0,100,8.8500,100,8.7700,0.0000,0,0
GDL-C,0,100,51.7900,500,50.9700,0.0000,0,0
GDMA,0,100,32.1500,100,31.9700,0.0000,0,0
GDO,0,200,17.8400,100,17.7100,0.0000,0,0
GDV-G,0,100,25.8600,100,25.5600,0.0000,0,0
GDV-H,0,100,27.5500,100,27.2000,0.0000,0,0
GDYNW,0,100,4.1400,100,4.0700,0.0000,0,0
GECCL,0,100,25.0700,100,24.7200,0.0000,0,0
GECCM,0,100,24.8800,100,24.4100,0.0000,0,0
GECCN,0,100,24.7400,100,24.1200,0.0000,0,0
GENY,0,100,62.3100,100,61.6900,0.0000,0,0
GERM,0,100,36.6700,300,36.2700,0.0000,0,0
GF,0,100,20.0400,100,19.8600,0.0000,0,0
GFED,0,100,19.0600,100,18.2300,0.0000,0,0
GGN-B,0,100,25.6000,100,25.3000,0.0000,0,0
GGO,0,100,13.6500,100,12.9500,0.0000,0,0
GGT-E,0,100,26.4300,100,26.0000,0.0000,0,0
GGT-G,0,100,26.4900,100,26.1300,0.0000,0,0
GGZ-A,0,100,26.1700,100,25.8200,0.0000,0,0
GIX=,0,100,13.3100,100,12.2100,0.0000,0,0
GIX^,0,200,0.6400,200,0.3527,0.0000,0,0
GJH,0,100,10.4400,100,10.3100,0.0000,0,0
GJO,0,100,24.0400,100,23.3700,0.0000,0,0
GJP,0,100,26.9300,100,23.0400,0.0000,0,0
GJR,0,100,24.2100,100,22.9800,0.0000,0,0
GJS,0,200,22.9900,200,19.8100,0.0000,0,0
GLADL,0,100,26.1000,100,25.3300,0.0000,0,0
GLAQU,0,100,10.7900,100,10.6900,0.0000,0,0
GLBZ,0,100,11.4900,100,10.9600,0.0000,0,0
GLCN,0,200,51.0100,200,50.8300,0.0000,0,0
GLEO,0,100,10.3800,200,10.3100,0.0000,0,0
GLEO+,0,100,1.1200,100,1.0100,0.0000,0,0
GLEO=,0,100,12.2700,100,11.0300,0.0000,0,0
GLIF,0,100,24.6500,100,24.3600,0.0000,0,0
GLIN,0,100,34.5900,100,34.1700,0.0000,0,0
GLOG-A,0,100,24.7200,100,24.0400,0.0000,0,0
GLOP-A,0,100,19.4200,100,19.1800,0.0000,0,0
GLOP-C,0,100,18.2900,100,18.1000,0.0000,0,0
GLP-A,0,100,25.9500,100,25.7000,0.0000,0,0
GLRY,0,100,30.6400,100,30.3300,0.0000,0,0
GLU-A,0,200,49.1200,100,46.0900,0.0000,0,0
GLU-B,0,100,52.1000,100,51.3500,0.0000,0,0
GMBLW,0,100,4.4000,100,4.0700,0.0000,0,0
GMF,0,100,139.9900,200,139.4100,0.0000,0,0
GMRE-A,0,100,26.1000,100,25.6500,0.0000,0,0
GNE-A,0,100,9.0300,100,8.9100,0.0000,0,0
GNFT,0,100,5.7800,1,5.6000,0.0000,0,0
GNL-A,0,100,25.9200,100,25.6700,0.0000,0,0
GNT-A,0,100,26.1000,100,25.7400,0.0000,0,0
GOAC+,0,100,1.7300,100,1.6400,0.0000,0,0
GOEX,0,100,33.5100,100,33.0500,0.0000,0,0
GOODM,0,100,25.3800,105,25.1500,0.0000,0,0
GPJA,0,100,27.7700,100,27.4200,0.0000,0,0
GQRE,0,600,58.0500,500,57.8000,0.0000,0,0
GRCY,0,100,10.3300,100,10.1600,0.0000,0,0
GRCYU,0,100,11.5400,100,10.4600,0.0000,0,0
GRES,0,100,26.9100,100,26.6600,0.0000,0,0
GRIN,0,100,5.2300,100,5.0400,0.0000,0,0
GRNVR,0,100,0.5300,3,0.4320,0.0000,0,0
GRNVW,0,400,0.9500,100,0.9000,0.0000,0,0
GRU,0,100,4.2100,100,4.0600,0.0000,0,0
GS-C,0,100,25.3600,100,25.0500,0.0000,0,0
GSEE,0,100,60.0700,10,59.7000,0.0000,0,0
GSEU,0,400,34.0500,100,33.8000,0.0000,0,0
GSIG,0,380,50.4500,331,50.4200,0.0000,0,0
GSJY,0,400,38.1700,100,37.8800,0.0000,0,0
GSL-B,0,100,25.6000,100,25.3500,0.0000,0,0
GSLD,0,100,25.5900,100,25.3000,0.0000,0,0
GSMGW,0,100,0.1700,100,0.1300,0.0000,0,0
GSP,0,600,11.8500,600,11.7600,0.0000,0,0
GSPY,0,1200,20.6100,1500,20.6000,0.0000,0,0
GURE,0,100,4.4900,100,4.4100,0.0000,0,0
GURU,0,4600,46.4400,600,45.9400,0.0000,0,0
GUT,0,100,8.0500,100,7.9800,0.0000,0,0
GUT-C,0,100,26.2000,100,25.7500,0.0000,0,0
GVIP,0,100,94.4100,100,93.5800,0.0000,0,0
GXF,0,300,28.7000,100,28.4100,0.0000,0,0
GXG,0,300,32.8200,300,32.1900,0.0000,0,0
GXGXU,0,100,11.1900,100,10.8100,0.0000,0,0
GYC,0,100,25.4000,100,24.4600,0.0000,0,0
GYLD,0,100,13.8000,100,13.6500,0.0000,0,0
GYRO,0,100,16.9900,100,16.6000,0.0000,0,0
HAP,0,100,41.7900,100,41.5600,0.0000,0,0
HART,0,200,27.0300,200,23.9900,0.0000,0,0
HAWX,0,1000,31.0300,2000,30.9200,0.0000,0,0
HBANN,0,100,26.0100,100,25.8100,0.0000,0,0
HCAPZ,0,100,25.3500,100,24.9500,0.0000,0,0
HCRB,0,5000,41.7500,5000,41.6300,0.0000,0,0
HCXY,0,100,27.1000,100,26.5300,0.0000,0,0
HCXZ,0,100,25.6500,100,25.2700,0.0000,0,0
HDAW,0,100,25.2300,100,25.0000,0.0000,0,0
HDG,0,100,51.9800,100,51.3200,0.0000,0,0
HDMV,0,500,31.2000,400,30.9300,0.0000,0,0
HERD,0,100,30.5300,100,30.0800,0.0000,0,0
HEWC,0,100,27.9800,100,27.7400,0.0000,0,0
HEWG,0,2300,30.1400,100,30.1200,0.0000,0,0
HEWW,0,100,16.2500,100,16.0900,0.0000,0,0
HFBL,0,100,30.6200,100,28.9100,0.0000,0,0
HFRO-A,0,100,26.2000,100,25.6800,0.0000,0,0
HFXI,0,600,23.6000,500,23.4000,0.0000,0,0
HIG-G,0,100,28.2900,100,28.0200,0.0000,0,0
HIHO,0,100,4.3000,1,4.1700,0.0000,0,0
HIPR,0,700,61.5600,700,61.4100,0.0000,0,0
HIPS,0,500,13.8800,500,13.8100,0.0000,0,0
HJLIW,0,100,0.3105,100,0.2368,0.0000,0,0
HJPX,0,1300,33.4100,1300,33.2900,0.0000,0,0
HKIB,0,100,6.5400,100,6.2500,0.0000,0,0
HL-B,0,100,61.2500,200,54.6300,0.0000,0,0
HLG,0,100,65.7500,100,64.5600,0.0000,0,0
HLM-,0,100,29.7600,100,29.4000,0.0000,0,0
HLXA,0,100,11.2900,100,11.0800,0.0000,0,0
HMG,0,100,12.2800,100,11.9900,0.0000,0,0
HMLP-A,0,54,25.2700,100,25.1800,0.0000,0,0
HMNF,0,100,18.2200,100,17.6300,0.0000,0,0
HMOP,0,200,42.0100,300,41.7800,0.0000,0,0
HNP,0,100,15.6200,100,15.5000,0.0000,0,0
HOLD,0,100,99.2500,100,98.3300,0.0000,0,0
HOLUU,0,100,10.8900,100,10.6600,0.0000,0,0
HOLUW,0,100,1.8100,100,1.5600,0.0000,0,0
HOVNP,0,100,8.9200,100,8.7100,0.0000,0,0
HPX=,0,400,11.2500,500,10.9600,0.0000,0,0
HQI,0,100,10.2400,100,10.0100,0.0000,0,0
HSAQ,0,100,12.6500,100,12.3600,0.0000,0,0
HSCZ,0,200,33.3000,4300,33.1900,0.0000,0,0
HSMV,0,900,29.2500,1000,29.2100,0.0000,0,0
HTAB,0,100,21.9200,100,21.6400,0.0000,0,0
HTFA,0,100,25.6500,100,25.3200,0.0000,0,0
HTIA,0,100,24.4700,100,24.2200,0.0000,0,0
HTUS,0,100,29.5900,100,29.0400,0.0000,0,0
HVBC,0,100,17.4600,100,16.4400,0.0000,0,0
HVT.A,0,100,33.5500,100,32.8500,0.0000,0,0
HWBK,0,100,20.5100,100,20.1700,0.0000,0,0
HWCPL,0,100,25.6200,100,25.4000,0.0000,0,0
HWCPZ,0,100,27.1200,100,26.8000,0.0000,0,0
HWM-,0,200,82.9500,200,73.1500,0.0000,0,0
HX,0,100,2.6300,1100,2.5600,0.0000,0,0
HYBB,0,100,52.2000,100,52.1600,0.0000,0,0
HYGH,0,200,86.9200,200,86.7200,0.0000,0,0
HYGV,0,200,49.6100,200,49.5400,0.0000,0,0
HYMCW,0,100,1.3900,100,1.3000,0.0000,0,0
HYTR,0,100,24.2300,800,24.1000,0.0000,0,0
HYUP,0,300,48.5000,300,48.4300,0.0000,0,0
HYXF,0,100,52.7900,100,52.3200,0.0000,0,0
HYZD,0,100,22.1500,100,21.9800,0.0000,0,0
HZAC=,0,200,11.3500,900,11.2600,0.0000,0,0
HZON+,0,200,2.1300,100,2.0700,0.0000,0,0
IAF,0,2100,5.4900,100,5.4700,0.0000,0,0
IBCE,0,600,25.1400,600,24.8400,0.0000,0,0
IBDD,0,600,27.3700,600,27.1100,0.0000,0,0
IBDQ,0,5600,27.2700,500,27.2400,0.0000,0,0
IBDT,0,1500,29.4500,1100,29.2000,0.0000,0,0
IBDU,0,1100,27.3300,1100,27.0800,0.0000,0,0
IBHF,0,672,25.5200,92,25.4800,0.0000,0,0
IBMJ,0,800,25.8300,80,25.7600,0.0000,0,0
IBMP,0,7800,27.3200,7700,27.2500,0.0000,0,0
IBND,0,1600,37.7200,100,37.5000,0.0000,0,0
IBTA,0,32500,25.3600,32500,25.3400,0.0000,0,0
IBTD,0,35000,25.7200,35000,25.7000,0.0000,0,0
IBTE,0,35000,25.9000,35000,25.8800,0.0000,0,0
IBTF,0,35000,26.0200,35000,26.0000,0.0000,0,0
IBTG,0,25000,26.0700,35000,26.0600,0.0000,0,0
IBTK,0,100,24.1900,100,23.9900,0.0000,0,0
ICCH,0,100,14.3000,100,14.0600,0.0000,0,0
ICOL,0,100,11.4000,100,11.2400,0.0000,0,0
IDE,0,100,10.8700,100,10.7600,0.0000,0,0
IDHQ,0,100,30.3600,100,29.7700,0.0000,0,0
IDIV,0,100,10.8300,100,10.6600,0.0000,0,0
IDLB,0,100,30.3300,100,30.0900,0.0000,0,0
IDX,0,100,21.8700,600,21.7900,0.0000,0,0
IFGL,0,300,27.0200,300,26.8800,0.0000,0,0
IGACW,0,100,1.9500,100,1.8500,0.0000,0,0
IGIC,0,100,8.2400,100,7.5600,0.0000,0,0
IGICW,0,100,0.7800,300,0.7100,0.0000,0,0
IHDG,0,3000,40.9600,1800,40.7900,0.0000,0,0
IIF,0,100,22.6900,200,22.5200,0.0000,0,0
IIGD,0,300,26.9300,100,26.9200,0.0000,0,0
IIGV,0,500,27.9800,400,27.9600,0.0000,0,0
IIPR-A,0,100,31.9600,100,31.1400,0.0000,0,0
IJUL,0,400,24.1800,200,24.0100,0.0000,0,0
IKNX,0,100,11.0900,100,10.8100,0.0000,0,0
IMACW,0,300,0.6155,300,0.2880,0.0000,0,0
IMH,0,250,2.9000,200,2.8000,0.0000,0,0
IMLP,0,400,10.5700,400,10.5200,0.0000,0,0
IMRN,0,200,7.3300,100,7.2300,0.0000,0,0
IMRNW,0,100,1.2200,300,1.1200,0.0000,0,0
IMTB,0,200,52.2200,200,52.1700,0.0000,0,0
INBKL,0,200,26.6300,200,23.9500,0.0000,0,0
INBKZ,0,100,26.9400,100,25.6500,0.0000,0,0
INCO,0,100,51.4800,100,51.0500,0.0000,0,0
INDF,0,100,32.3500,100,31.8900,0.0000,0,0
INFL,0,1200,25.1800,100,25.0000,0.0000,0,0
INFR,0,100,30.1400,100,29.7500,0.0000,0,0
INKAU,0,1300,10.6000,700,10.5500,0.0000,0,0
INN-E,0,100,23.3300,100,23.0600,0.0000,0,0
INSW-A,0,100,25.9000,100,25.3700,0.0000,0,0
INTG,0,100,31.3700,100,30.3800,0.0000,0,0
IOR,0,100,12.4500,100,11.5700,0.0000,0,0
IPB,0,200,31.0000,100,29.8800,0.0000,0,0
IPHA,0,935,4.8000,100,4.4500,0.0000,0,0
IPKW,0,100,40.8900,100,40.7600,0.0000,0,0
IPV=,0,400,20.3300,100,18.8200,0.0000,0,0
IQDY,0,100,29.9300,100,29.6500,0.0000,0,0
IQIN,0,400,30.5800,400,30.3100,0.0000,0,0
IQSI,0,400,28.2900,100,28.0500,0.0000,0,0
IQSU,0,700,33.2600,100,33.1000,0.0000,0,0
IRL,0,100,11.0400,100,10.9200,0.0000,0,0
IROQ,0,100,21.9000,100,20.5500,0.0000,0,0
ISCF,0,1000,34.4700,1000,34.3400,0.0000,0,0
ISD,0,1,15.1500,100,15.0800,0.0000,0,0
ISDX,0,100,28.8000,100,28.5000,0.0000,0,0
ISEM,0,100,29.4000,100,29.1100,0.0000,0,0
ISHG,0,400,85.2100,100,84.4100,0.0000,0,0
ISMD,0,100,32.6500,100,32.4700,0.0000,0,0
ISZE,0,100,30.4400,100,30.0700,0.0000,0,0
ITACU,0,100,11.4400,100,11.0300,0.0000,0,0
ITMR,0,100,25.2400,200,24.8800,0.0000,0,0
IVES,0,500,54.2200,402,53.5000,0.0000,0,0
IVR-A,0,100,24.9700,100,24.6600,0.0000,0,0
IWFH,0,1000,32.2400,1000,32.1900,0.0000,0,0
IXSE,0,100,30.6100,100,30.3300,0.0000,0,0
JAAA,0,2500,50.5200,100,50.2800,0.0000,0,0
JANZ,0,4000,25.8300,1000,25.7300,0.0000,0,0
JBK,0,100,30.3600,100,29.6400,0.0000,0,0
JCE,0,500,14.3900,100,14.2400,0.0000,0,0
JCS,0,100,4.7900,100,4.6700,0.0000,0,0
JDIV,0,100,28.2700,100,28.1000,0.0000,0,0
JEMD,0,100,7.7500,800,7.6500,0.0000,0,0
JEQ,0,100,9.8000,100,9.6200,0.0000,0,0
JHI,0,100,17.6300,100,17.4400,0.0000,0,0
JHMA,0,200,41.6900,2500,41.5200,0.0000,0,0
JHME,0,2500,16.1800,2500,16.1300,0.0000,0,0
JHMT,0,100,83.2800,1800,82.9800,0.0000,0,0
JHMU,0,2500,30.7600,2500,30.7100,0.0000,0,0
JHX,0,100,29.3900,100,29.1800,0.0000,0,0
JIGB,0,100,57.0100,100,56.6900,0.0000,0,0
JIH=,0,400,14.1200,900,13.2600,0.0000,0,0
JJA,0,100,55.1400,500,54.7900,0.0000,0,0
JJE,0,100,28.3900,100,27.6400,0.0000,0,0
JJM,0,100,52.7800,100,51.8000,0.0000,0,0
JJP,0,100,67.5200,100,66.5100,0.0000,0,0
JJS,0,100,44.7700,100,43.9100,0.0000,0,0
JJT,0,100,58.5300,100,57.5200,0.0000,0,0
JJU,0,100,43.5200,100,42.4600,0.0000,0,0
JKD,0,100,221.2000,850,221.1200,0.0000,0,0
JKH,0,100,398.7200,100,398.4000,0.0000,0,0
JKI,0,100,164.6000,100,164.5200,0.0000,0,0
JKJ,0,100,210.0900,100,208.9700,0.0000,0,0
JMIN,0,500,32.1500,100,31.9800,0.0000,0,0
JMP,0,100,4.1400,100,3.9700,0.0000,0,0
JMPNL,0,100,25.0400,100,24.8300,0.0000,0,0
JMPNZ,0,100,24.0900,100,23.6600,0.0000,0,0
JOET,0,100,26.6400,5100,26.5900,0.0000,0,0
JOYY,0,100,33.8300,100,33.5000,0.0000,0,0
JPEM,0,500,57.2400,500,57.0500,0.0000,0,0
JPME,0,1100,78.8300,1100,78.3800,0.0000,0,0
JPN,0,300,33.4400,200,33.3300,0.0000,0,0
JPT,0,100,24.6300,100,24.3900,0.0000,0,0
JPUS,0,300,86.8400,2610,86.8000,0.0000,0,0
JPXN,0,100,74.1900,100,73.6900,0.0000,0,0
JSMD,0,100,67.1400,100,66.3600,0.0000,0,0
JSTC,0,100,15.9700,100,15.7800,0.0000,0,0
JULZ,0,1000,29.9100,1000,29.6900,0.0000,0,0
JUPWW,0,200,0.9600,200,0.7900,0.0000,0,0
JUST,0,100,56.1300,400,55.6400,0.0000,0,0
JVAL,0,100,31.6300,100,31.4600,0.0000,0,0
JW.B,0,100,48.7500,100,47.7600,0.0000,0,0
JXI,0,600,60.7500,600,60.5000,0.0000,0,0
KALL,0,200,38.4300,200,38.1800,0.0000,0,0
KBNTW,0,100,2.0000,100,1.8600,0.0000,0,0
KBWR,0,200,52.5200,300,52.0300,0.0000,0,0
KCAPL,0,100,25.3000,100,24.9500,0.0000,0,0
KCE,0,600,78.8900,100,78.4600,0.0000,0,0
KCNY,0,100,35.3700,100,34.8200,0.0000,0,0
KDFI,0,100,21.8100,100,21.5800,0.0000,0,0
KELYB,0,100,20.9600,100,20.5400,0.0000,0,0
KEMX,0,100,32.2900,100,32.0100,0.0000,0,0
KEN,0,500,30.9000,100,30.5600,0.0000,0,0
KESG,0,100,35.5100,400,35.1500,0.0000,0,0
KFS,0,100,4.8500,100,4.7300,0.0000,0,0
KFYP,0,100,34.3800,500,33.9400,0.0000,0,0
KINS,0,100,7.4400,100,7.2900,0.0000,0,0
KKR-B,0,100,26.0200,100,25.8500,0.0000,0,0
KLCD,0,500,29.4400,200,29.3700,0.0000,0,0
KLDW,0,300,43.4800,300,43.2500,0.0000,0,0
KMLM,0,100,26.8700,400,26.7700,0.0000,0,0
KOIN,0,100,39.5600,100,39.1200,0.0000,0,0
KOKU,0,100,74.3100,100,73.4600,0.0000,0,0
KRBN,0,200,25.7700,300,25.0000,0.0000,0,0
KSMT,0,100,10.3700,100,10.2000,0.0000,0,0
KSMTU,0,100,11.2400,100,10.6600,0.0000,0,0
KSU-,0,200,41.3200,200,33.6800,0.0000,0,0
KTH,0,100,34.0200,100,33.2700,0.0000,0,0
KTN,0,100,32.8100,100,32.3800,0.0000,0,0
KVLE,0,100,21.2400,100,21.0400,0.0000,0,0
KWAC=,0,100,10.6400,400,10.5500,0.0000,0,0
LACQ,0,100,12.8200,100,11.6800,0.0000,0,0
LACQU,0,100,14.3600,100,12.2100,0.0000,0,0
LANDP,0,100,25.2100,100,24.9600,0.0000,0,0
LATNU,0,100,11.8000,100,11.3700,0.0000,0,0
LATNW,0,100,1.2000,100,1.0800,0.0000,0,0
LBRDP,0,100,28.6100,100,28.3400,0.0000,0,0
LCG,0,200,26.2500,200,26.1100,0.0000,0,0
LCR,0,100,29.1100,100,28.8300,0.0000,0,0
LCYAW,0,100,2.1800,100,2.0400,0.0000,0,0
LD,0,200,42.4300,200,41.8700,0.0000,0,0
LDRS,0,200,29.0800,200,28.9200,0.0000,0,0
LEAP=,0,200,16.0000,500,15.6200,0.0000,0,0
LEVLP,0,100,29.6100,100,26.7200,0.0000,0,0
LFT,0,300,3.3400,100,3.2700,0.0000,0,0
LGL,0,100,11.1900,100,10.9700,0.0000,0,0
LGL+,0,100,0.5312,100,0.2952,0.0000,0,0
LGOV,0,100,28.5400,200,28.4300,0.0000,0,0
LIV,0,1000,27.2200,600,27.1500,0.0000,0,0
LIVKU,0,100,11.1900,100,10.8000,0.0000,0,0
LMRKN,0,100,26.0200,100,25.7000,0.0000,0,0
LMRKO,0,100,25.5500,100,25.3200,0.0000,0,0
LMRKP,0,100,25.1500,100,24.9000,0.0000,0,0
LOACR,0,100,1.1900,100,1.0800,0.0000,0,0
LOACU,0,100,17.0600,100,15.9400,0.0000,0,0
LOWC,0,300,118.8300,300,117.7400,0.0000,0,0
LQDH,0,100,95.5200,100,95.1400,0.0000,0,0
LRNZ,0,200,50.7900,200,50.6600,0.0000,0,0
LSAQ,0,100,11.0400,100,10.9100,0.0000,0,0
LSAT,0,2000,30.3700,2000,30.2800,0.0000,0,0
LSBK,0,100,13.4700,400,12.9500,0.0000,0,0
LSST,0,300,25.6700,300,25.6100,0.0000,0,0
LSXMB,0,100,45.4200,95,41.0400,0.0000,0,0
LUXAW,0,100,2.5700,100,2.4600,0.0000,0,0
LVOL,0,500,40.3300,500,40.2800,0.0000,0,0
LXEH,0,100,8.7300,100,8.3900,0.0000,0,0
LXP-C,0,100,58.2900,100,57.3600,0.0000,0,0
MAA-I,0,100,67.3300,100,65.2700,0.0000,0,0
MACU,0,100,10.2900,100,10.0900,0.0000,0,0
MACUW,0,100,0.9200,200,0.8400,0.0000,0,0
MARB,0,5000,19.5700,5100,19.5200,0.0000,0,0
MAV,0,100,11.7700,100,11.6900,0.0000,0,0
MAYS,0,100,26.3500,100,24.4100,0.0000,0,0
MBBB,0,8200,25.2300,8200,25.2000,0.0000,0,0
MBINO,0,100,25.8500,100,25.5100,0.0000,0,0
MBINP,0,100,27.0200,100,26.4500,0.0000,0,0
MBNKP,0,100,20.8300,100,20.1200,0.0000,0,0
MBSD,0,1000,24.0700,1000,23.9800,0.0000,0,0
MCACR,0,200,1.1700,200,1.0400,0.0000,0,0
MCACU,0,100,13.0500,100,11.6000,0.0000,0,0
MCADU,0,100,10.6400,100,10.4500,0.0000,0,0
MCEF,0,600,20.3200,200,20.1900,0.0000,0,0
MCI,0,2500,13.5000,100,13.3800,0.0000,0,0
MCMJW,0,100,1.7600,100,1.6100,0.0000,0,0
MCRO,0,1600,28.9000,1500,28.8200,0.0000,0,0
MDGSW,0,200,0.8100,200,0.6100,0.0000,0,0
MER-K,0,100,27.2500,120,27.1000,0.0000,0,0
MET-E,0,100,27.7600,100,27.4700,0.0000,0,0
MFA-C,0,100,21.6100,100,21.4200,0.0000,0,0
MFDX,0,400,28.3200,500,28.1000,0.0000,0,0
MFEM,0,400,29.8000,200,29.6600,0.0000,0,0
MFINL,0,100,25.4200,100,25.1300,0.0000,0,0
MFT,0,100,14.5300,100,14.3700,0.0000,0,0
MFV,0,100,5.9900,100,5.8700,0.0000,0,0
MGMT,0,100,29.4000,100,29.1500,0.0000,0,0
MGR,0,100,27.3800,100,27.0900,0.0000,0,0
MGYR,0,100,10.1300,100,9.4700,0.0000,0,0
MH-A,0,100,11.7200,100,11.4100,0.0000,0,0
MH-C,0,100,11.4800,100,11.3600,0.0000,0,0
MH-D,0,100,11.5200,100,11.3100,0.0000,0,0
MHD,0,100,16.2700,100,16.1900,0.0000,0,0
MHE,0,100,13.7500,100,13.5500,0.0000,0,0
MHF,0,200,7.7700,100,7.6800,0.0000,0,0
MHLA,0,100,21.3300,100,21.1000,0.0000,0,0
MHNC,0,100,23.0300,100,22.8100,0.0000,0,0
MIDF,0,400,33.1800,500,33.1300,0.0000,0,0
MINDP,0,100,23.1400,100,22.7100,0.0000,0,0
MITT-A,0,100,20.2800,100,19.9300,0.0000,0,0
MITT-B,0,100,20.0000,100,19.7900,0.0000,0,0
MITT-C,0,100,19.8100,100,19.4800,0.0000,0,0
MIXT,0,100,13.8000,100,13.6600,0.0000,0,0
MJJ,0,100,82.4300,100,80.2400,0.0000,0,0
MKC.V,0,100,93.6600,100,90.0100,0.0000,0,0
MLACU,0,100,10.9200,100,10.6300,0.0000,0,0
MLPB,0,1500,12.7800,3200,12.7000,0.0000,0,0
MLPO,0,100,8.7300,100,7.4700,0.0000,0,0
MLPR,0,200,25.8900,100,24.5700,0.0000,0,0
MLPY,0,4200,3.6300,2300,3.5200,0.0000,0,0
MMLG,0,1000,24.6700,1200,24.6400,0.0000,0,0
MN,0,300,6.0900,100,5.9900,0.0000,0,0
MNPR,0,100,6.9400,100,6.7700,0.0000,0,0
MNSBP,0,100,26.2000,100,25.7000,0.0000,0,0
MOG.B,0,100,81.2800,100,76.2000,0.0000,0,0
MOTN,0,100,10.7800,100,10.4600,0.0000,0,0
MOTNU,0,100,10.8900,100,10.6700,0.0000,0,0
MOTNW,0,100,1.9400,100,1.8100,0.0000,0,0
MOTO,0,400,45.0500,400,44.8300,0.0000,0,0
MPA,0,100,14.6500,100,14.5200,0.0000,0,0
MRCCL,0,100,25.2900,100,24.9400,0.0000,0,0
MRGR,0,300,39.7800,1100,39.6500,0.0000,0,0
MSC,0,100,15.8100,100,14.9900,0.0000,0,0
MSD,0,100,9.1700,100,9.0800,0.0000,0,0
MSVB,0,100,15.7500,100,14.4100,0.0000,0,0
MTBCP,0,100,27.0100,100,26.6600,0.0000,0,0
MTGP,0,100,51.6300,100,51.5600,0.0000,0,0
MUDSU,0,100,10.6700,100,10.5600,0.0000,0,0
MUI,0,100,14.8200,100,14.7000,0.0000,0,0
MUS,0,100,13.4100,100,13.2700,0.0000,0,0
MUST,0,200,22.4900,200,22.4300,0.0000,0,0
MVRL,0,200,42.2300,100,40.4100,0.0000,0,0
MXE,0,659,10.1900,200,9.8800,0.0000,0,0
MYJ,0,200,14.4200,200,14.3300,0.0000,0,0
MYN,0,1000,13.3600,1200,13.2500,0.0000,0,0
MYY,0,2729,27.5600,1300,27.5300,0.0000,0,0
MZA,0,100,15.6100,100,15.4400,0.0000,0,0
NAPR,0,760,35.6700,200,35.5800,0.0000,0,0
NAV-D,0,100,16.0100,100,14.3000,0.0000,0,0
NAZ,0,100,15.1700,100,15.0300,0.0000,0,0
NBACR,0,100,1.7200,600,1.6200,0.0000,0,0
NBACU,0,100,24.5900,100,22.6200,0.0000,0,0
NBO,0,200,12.2900,100,12.2300,0.0000,0,0
NBW,0,100,13.5300,100,13.4100,0.0000,0,0
NCSM,0,100,39.4200,100,37.0600,0.0000,0,0
NCV-A,0,4,26.5200,100,26.2800,0.0000,0,0
NCZ-A,0,100,26.4100,100,26.1000,0.0000,0,0
NDRAW,0,300,0.5504,300,0.2964,0.0000,0,0
NEE-N,0,100,28.0100,100,27.6900,0.0000,0,0
NEN,0,100,52.0500,100,51.0000,0.0000,0,0
NESRW,0,300,1.5900,300,1.1600,0.0000,0,0
NEV,0,100,16.2700,100,16.1000,0.0000,0,0
NEWTI,0,100,25.3500,100,25.1500,0.0000,0,0
NEWTL,0,100,25.5400,100,25.2000,0.0000,0,0
NFH+,0,300,2.0400,100,1.7800,0.0000,0,0
NFLT,0,100,25.6900,100,25.4600,0.0000,0,0
NFTY,0,100,41.0600,100,40.1600,0.0000,0,0
NGHCP,0,100,25.1700,100,24.9700,0.0000,0,0
NGHCZ,0,100,25.3500,100,25.1400,0.0000,0,0
NHICU,0,100,11.2900,100,10.8600,0.0000,0,0
NHICW,0,100,1.5900,100,1.5200,0.0000,0,0
NHLD,0,100,3.3400,200,3.2300,0.0000,0,0
NHLDW,0,200,0.1378,200,0.0720,0.0000,0,0
NIB,0,100,30.8700,100,30.4800,0.0000,0,0
NICK,0,100,9.6300,100,8.9600,0.0000,0,0
NID,0,100,14.2300,100,14.1200,0.0000,0,0
NJUL,0,400,45.1100,200,44.8700,0.0000,0,0
NJV,0,100,14.2000,200,14.0500,0.0000,0,0
NKX,0,100,15.4700,100,15.3500,0.0000,0,0
NLR,0,100,49.9300,100,49.3600,0.0000,0,0
NLY-I,0,100,25.3800,100,25.1200,0.0000,0,0
NM-G,0,200,6.4400,200,5.4800,0.0000,0,0
NM-H,0,100,6.1400,100,5.1700,0.0000,0,0
NMFCL,0,100,25.3500,100,25.0600,0.0000,0,0
NMI,0,100,11.5400,100,11.3900,0.0000,0,0
NMK-B,0,10,101.4000,10,99.1100,0.0000,0,0
NMK-C,0,10,104.4100,10,101.7100,0.0000,0,0
NMMC,0,100,11.7600,1,10.7000,0.0000,0,0
NMMCU,0,100,11.8900,100,11.2100,0.0000,0,0
NMT,0,100,14.9600,100,14.8200,0.0000,0,0
NNY,0,100,10.1100,100,9.9900,0.0000,0,0
NOM,0,200,14.1700,202,14.0200,0.0000,0,0
NOVSU,0,400,37.0500,500,34.4700,0.0000,0,0
NPAUU,0,100,18.4400,4,17.9500,0.0000,0,0
NPN,0,347,14.1000,200,13.8600,0.0000,0,0
NPV,0,200,15.7300,100,15.5900,0.0000,0,0
NREF-A,0,100,26.4400,100,25.3400,0.0000,0,0
NRP,0,100,16.0900,100,15.7900,0.0000,0,0
NSA-A,0,100,26.8500,300,26.1800,0.0000,0,0
NSCO+,0,100,1.1300,100,1.0500,0.0000,0,0
NSEC,0,100,11.6200,100,10.5100,0.0000,0,0
NSH=,0,100,11.3900,10,11.3400,0.0000,0,0
NSS,0,100,23.7900,100,23.5000,0.0000,0,0
NTIP,0,100,3.8400,100,3.7200,0.0000,0,0
NTRSO,0,100,27.0200,100,26.7300,0.0000,0,0
NTWK,0,200,4.2100,100,4.1500,0.0000,0,0
NUBD,0,2682,26.6500,3181,26.6200,0.0000,0,0
NUSA,0,1299,25.5200,1145,25.4900,0.0000,0,0
NVQ,0,100,29.1600,100,28.9800,0.0000,0,0
NXC,0,100,16.5400,100,16.2500,0.0000,0,0
NXQ,0,100,15.8200,100,15.6600,0.0000,0,0
NXR,0,100,17.1000,100,16.8800,0.0000,0,0
NYCB-U,0,100,46.5100,100,46.0700,0.0000,0,0
NYF,0,500,58.4400,500,58.1900,0.0000,0,0
NYMTO,0,100,23.7300,100,23.4600,0.0000,0,0
NYMTP,0,100,23.7400,100,23.4200,0.0000,0,0
OACB+,0,100,2.2000,100,2.0600,0.0000,0,0
OAK-A,0,100,27.5100,100,27.1500,0.0000,0,0
OAK-B,0,31,27.6000,600,27.5800,0.0000,0,0
OBAS,0,100,11.8400,400,11.5000,0.0000,0,0
OBOR,0,400,29.1400,100,28.9100,0.0000,0,0
OCC,0,100,3.2900,100,3.1900,0.0000,0,0
OCCIP,0,100,25.0900,100,24.9000,0.0000,0,0
OCFCP,0,100,27.8900,100,27.3900,0.0000,0,0
OCIO,0,200,30.7500,100,30.7200,0.0000,0,0
OCTZ,0,1000,27.7700,1000,27.6700,0.0000,0,0
OFG-A,0,100,25.8700,100,25.4600,0.0000,0,0
OFG-B,0,100,25.7600,100,25.3500,0.0000,0,0
OFG-D,0,100,26.1000,100,25.6600,0.0000,0,0
OFSSG,0,100,25.1500,100,24.9000,0.0000,0,0
OFSSI,0,100,23.9400,100,23.6100,0.0000,0,0
OFSSL,0,100,25.0400,100,24.6600,0.0000,0,0
OFSSZ,0,100,25.0700,100,24.6800,0.0000,0,0
OGCP,0,1,9.1700,200,8.8200,0.0000,0,0
OLD,0,100,30.3200,300,29.8700,0.0000,0,0
ONEO,0,500,88.9300,500,88.8000,0.0000,0,0
ONEV,0,100,92.7500,500,92.6900,0.0000,0,0
ONEY,0,100,80.4800,100,79.5900,0.0000,0,0
ONTXW,0,100,0.2021,100,0.1818,0.0000,0,0
OPER,0,100,100.1000,100,100.0800,0.0000,0,0
OPINI,0,100,25.5100,100,25.2500,0.0000,0,0
OPP-A,0,100,24.8400,100,24.6200,0.0000,0,0
OSN,0,100,4.7600,100,4.6400,0.0000,0,0
OTEL,0,800,11.6500,100,11.5700,0.0000,0,0
OTLKW,0,300,0.3187,300,0.1519,0.0000,0,0
OTRA,0,900,10.3500,100,10.2100,0.0000,0,0
OTRAU,0,100,10.8800,100,10.7300,0.0000,0,0
OTRAW,0,200,1.3500,200,1.1600,0.0000,0,0
OVB,0,500,26.3700,500,26.2200,0.0000,0,0
OVL,0,500,33.0700,500,32.9100,0.0000,0,0
OVM,0,100,26.1300,100,25.8300,0.0000,0,0
OVS,0,100,32.9500,100,32.6200,0.0000,0,0
OVT,0,200,26.4100,200,23.6800,0.0000,0,0
OXLCM,0,100,24.6800,100,24.3300,0.0000,0,0
OXLCO,0,100,25.2500,100,25.0000,0.0000,0,0
OXLCP,0,100,23.8000,100,23.5100,0.0000,0,0
OXSQL,0,100,25.2500,100,24.9600,0.0000,0,0
OXSQZ,0,100,25.5500,100,24.9000,0.0000,0,0
PACE=,0,400,11.9800,900,11.8000,0.0000,0,0
PAEWW,0,100,2.5400,200,2.2400,0.0000,0,0
PAI,0,229,15.6600,100,15.5400,0.0000,0,0
PAIC,0,100,10.3400,100,10.1600,0.0000,0,0
PAICU,0,100,12.4800,100,11.2100,0.0000,0,0
PAICW,0,100,1.2000,100,1.1000,0.0000,0,0
PAMC,0,100,34.7800,4000,34.7200,0.0000,0,0
PANA+,0,100,2.9000,100,2.7600,0.0000,0,0
PAVMW,0,300,0.6912,300,0.2986,0.0000,0,0
PAVMZ,0,100,1.2400,100,1.1200,0.0000,0,0
PBC,0,100,26.1800,100,25.8200,0.0000,0,0
PBDM,0,500,28.4100,552,28.2500,0.0000,0,0
PBEE,0,300,31.1000,100,31.0000,0.0000,0,0
PBHC,0,100,13.5000,100,12.9500,0.0000,0,0
PBTS,0,100,2.8400,100,2.8000,0.0000,0,0
PBY,0,100,25.9500,100,25.5300,0.0000,0,0
PCG-A,0,100,30.5200,100,29.8900,0.0000,0,0
PCG-B,0,200,29.5800,200,26.0300,0.0000,0,0
PCG-C,0,100,25.8900,100,24.7500,0.0000,0,0
PCG-D,0,200,27.3000,200,23.9400,0.0000,0,0
PCG-E,0,100,26.0900,100,24.7900,0.0000,0,0
PCG-G,0,200,26.2500,200,22.8100,0.0000,0,0
PCG-H,0,100,24.4200,100,23.1600,0.0000,0,0
PCM,0,100,11.2900,100,11.1700,0.0000,0,0
PCN,0,100,17.2100,100,17.0800,0.0000,0,0
PCPL=,0,100,11.8400,900,11.7500,0.0000,0,0
PCQ,0,100,18.1900,100,17.9400,0.0000,0,0
PDEV,0,100,29.5300,100,29.2300,0.0000,0,0
PEB-D,0,100,23.6900,100,23.3300,0.0000,0,0
PEB-E,0,100,24.0800,100,23.6000,0.0000,0,0
PEX,0,1000,33.0000,300,32.8900,0.0000,0,0
PEXL,0,100,38.2800,100,37.9000,0.0000,0,0
PFD,0,100,19.3100,100,19.0200,0.0000,0,0
PFFL,0,100,18.8800,100,18.7100,0.0000,0,0
PFFR,0,300,23.6200,100,23.4900,0.0000,0,0
PFFV,0,100,27.5100,100,27.3900,0.0000,0,0
PFI,0,500,45.4000,2500,44.9700,0.0000,0,0
PFIN,0,1,6.2000,100,5.9900,0.0000,0,0
PFLD,0,700,25.1300,700,25.0300,0.0000,0,0
PFX,0,50,29.5000,100,28.5000,0.0000,0,0
PFXNL,0,200,26.3900,200,23.5600,0.0000,0,0
PGAL,0,800,11.3200,100,11.1300,0.0000,0,0
PGM,0,100,54.9800,100,52.7000,0.0000,0,0
PGP,0,100,10.2500,100,10.1200,0.0000,0,0
PHGE,0,100,6.6000,100,6.5100,0.0000,0,0
PHGE+,0,100,0.8500,200,0.5400,0.0000,0,0
PHIC,0,100,10.6800,100,10.2600,0.0000,0,0
PHICU,0,100,11.2000,100,10.8900,0.0000,0,0
PHICW,0,100,2.2500,100,1.7600,0.0000,0,0
PHUNW,0,100,0.2990,700,0.2100,0.0000,0,0
PIAI=,0,200,10.9200,100,10.8600,0.0000,0,0
PIFI,0,100,99.8100,100,99.7700,0.0000,0,0
PLAT,0,100,45.5600,100,45.1300,0.0000,0,0
PLYM-A,0,100,27.6100,100,26.5000,0.0000,0,0
PMAY,0,3500,28.6400,350,28.5600,0.0000,0,0
PMBC,0,100,5.8300,100,5.6600,0.0000,0,0
PML,0,700,14.5100,100,14.4100,0.0000,0,0
PMT-A,0,100,24.4400,100,24.0900,0.0000,0,0
PMVC,0,100,10.3100,100,10.2400,0.0000,0,0
PMVC+,0,100,1.4600,100,1.3400,0.0000,0,0
PMVC=,0,100,11.0200,100,10.8500,0.0000,0,0
PNBK,0,1670,11.0000,100,10.0500,0.0000,0,0
PNF,0,100,12.0700,100,11.9600,0.0000,0,0
PNI,0,100,11.2900,100,11.2000,0.0000,0,0
PNRG,0,100,40.9500,100,38.4500,0.0000,0,0
PPTY,0,500,29.4200,500,29.2100,0.0000,0,0
PQDI,0,300,21.5000,100,21.4500,0.0000,0,0
PQIN,0,100,58.8100,100,58.1800,0.0000,0,0
PQLC,0,100,62.8700,100,62.3100,0.0000,0,0
PQSG,0,700,67.8800,700,67.7400,0.0000,0,0
PQSV,0,700,55.9200,700,55.8100,0.0000,0,0
PRE-G,0,100,25.8300,100,25.5400,0.0000,0,0
PRE-H,0,100,25.8100,100,25.6600,0.0000,0,0
PRE-I,0,100,25.6600,100,25.3900,0.0000,0,0
PRIF-A,0,100,23.8100,100,23.5000,0.0000,0,0
PRIF-C,0,100,24.9600,100,24.5300,0.0000,0,0
PRIF-D,0,100,24.9700,100,24.6100,0.0000,0,0
PRIF-E,0,100,23.8900,100,23.6700,0.0000,0,0
PRIF-F,0,100,24.2400,100,23.9100,0.0000,0,0
PRTC,0,100,55.5000,100,49.1000,0.0000,0,0
PSA-O,0,100,25.5700,200,25.3600,0.0000,0,0
PSB-Z,0,900,26.4000,100,26.2500,0.0000,0,0
PSCC,0,100,92.4500,100,92.1700,0.0000,0,0
PSCD,0,200,93.5700,800,93.3900,0.0000,0,0
PSCF,0,200,51.9500,200,51.8400,0.0000,0,0
PSCI,0,100,86.1300,100,85.9200,0.0000,0,0
PSCM,0,200,61.3400,200,61.2000,0.0000,0,0
PSCU,0,200,56.7200,200,56.6100,0.0000,0,0
PSET,0,100,47.1400,100,46.8100,0.0000,0,0
PSL,0,100,88.8900,100,88.7600,0.0000,0,0
PSR,0,100,86.9400,100,86.8900,0.0000,0,0
PTICU,0,200,10.8400,100,10.7600,0.0000,0,0
PTIN,0,300,27.3700,300,27.2000,0.0000,0,0
PTK=,0,100,12.8400,100,10.8600,0.0000,0,0
PTNR,0,600,4.6900,200,4.5500,0.0000,0,0
PTVCA,0,100,16.3100,100,14.8500,0.0000,0,0
PUI,0,500,31.7800,2500,31.7500,0.0000,0,0
PUK-A,0,100,27.4000,100,27.0800,0.0000,0,0
PUTW,0,200,29.2200,100,29.0900,0.0000,0,0
PUYI,0,100,6.2300,100,5.9600,0.0000,0,0
PVI,0,400,24.9400,300,24.8200,0.0000,0,0
PW-A,0,200,27.6100,200,24.7000,0.0000,0,0
PWC,0,100,115.0300,100,114.4000,0.0000,0,0
PXE,0,1100,11.6300,3000,11.6000,0.0000,0,0
PXQ,0,300,89.1000,200,88.2600,0.0000,0,0
PXSAP,0,100,16.5900,100,15.4500,0.0000,0,0
PY,0,100,36.3500,100,35.9900,0.0000,0,0
PYN,0,253,8.9700,300,8.8700,0.0000,0,0
PYPE,0,100,15.0200,100,14.9100,0.0000,0,0
PYS,0,100,20.8400,100,20.1800,0.0000,0,0
PYT,0,100,23.7300,100,22.9100,0.0000,0,0
PYZ,0,100,75.1500,2000,74.5600,0.0000,0,0
QAT,0,100,19.0700,100,18.8400,0.0000,0,0
QDIV,0,500,27.1900,500,27.0700,0.0000,0,0
QDYN,0,500,53.4600,500,53.4200,0.0000,0,0
QEFA,0,100,71.9800,200,71.4200,0.0000,0,0
QEMM,0,200,69.7400,200,69.4200,0.0000,0,0
QINT,0,100,50.0000,100,49.6300,0.0000,0,0
QLS,0,100,26.0800,500,26.0600,0.0000,0,0
QLV,0,1000,46.4800,200,46.3300,0.0000,0,0
QLVE,0,100,28.5100,100,28.4300,0.0000,0,0
QMJ,0,100,59.7500,100,59.2300,0.0000,0,0
QMN,0,500,27.4900,500,27.4600,0.0000,0,0
QPT,0,2500,25.1900,2500,25.1300,0.0000,0,0
QQD,0,1000,27.4300,1000,27.2600,0.0000,0,0
QQXT,0,500,81.2500,500,81.1700,0.0000,0,0
QRFT,0,500,40.0000,500,39.8700,0.0000,0,0
QRTEB,0,100,11.8100,100,11.6600,0.0000,0,0
QSY,0,400,104.5500,400,104.2500,0.0000,0,0
QTS-A,0,100,27.0800,100,26.6800,0.0000,0,0
QTS-B,0,100,145.6800,100,144.6200,0.0000,0,0
QTUM,0,400,46.8100,400,46.5900,0.0000,0,0
QVCD,0,100,26.0000,100,25.7700,0.0000,0,0
QWLD,0,300,94.8800,100,94.4100,0.0000,0,0
RAFE,0,500,26.9100,200,26.8500,0.0000,0,0
RALS,0,100,31.1500,100,30.8600,0.0000,0,0
RAND,0,100,15.9500,100,15.5400,0.0000,0,0
RBIN,0,100,27.8200,100,27.5000,0.0000,0,0
RBKB,0,100,9.2400,100,8.8200,0.0000,0,0
RBND,0,200,25.1800,300,25.1500,0.0000,0,0
RBUS,0,700,35.9400,700,35.9000,0.0000,0,0
RCB,0,100,25.1500,100,24.8200,0.0000,0,0
RCHG,0,100,10.4400,100,10.2800,0.0000,0,0
RCHGU,0,100,11.0900,200,10.9400,0.0000,0,0
RCHGW,0,300,1.7300,100,1.5800,0.0000,0,0
RCP,0,100,25.2200,100,24.9900,0.0000,0,0
RDIB,0,100,23.7900,100,20.4200,0.0000,0,0
RDOG,0,100,41.6900,100,41.2700,0.0000,0,0
RECS,0,500,25.4400,200,25.3800,0.0000,0,0
RESP,0,4000,42.7200,200,42.3400,0.0000,0,0
REVS,0,500,17.5300,200,17.4700,0.0000,0,0
REXR-B,0,100,26.1000,100,25.8000,0.0000,0,0
REXR-C,0,100,26.8700,100,26.5300,0.0000,0,0
RFAP,0,400,58.9800,300,58.6800,0.0000,0,0
RFCI,0,100,25.9500,100,25.9300,0.0000,0,0
RFDA,0,300,39.2000,300,38.8100,0.0000,0,0
RFEM,0,200,75.7700,400,75.5200,0.0000,0,0
RFEU,0,100,67.4300,200,67.0800,0.0000,0,0
RFG,0,100,223.9700,100,223.7700,0.0000,0,0
RFUN,0,100,25.7800,100,25.6600,0.0000,0,0
RFV,0,200,79.4200,500,78.9700,0.0000,0,0
RGT,0,200,13.7000,100,13.5700,0.0000,0,0
RICE+,0,100,2.8300,100,2.7400,0.0000,0,0
RILYH,0,100,25.6600,100,25.3300,0.0000,0,0
RILYI,0,100,25.4800,100,25.1600,0.0000,0,0
RILYL,0,100,26.6500,100,26.2000,0.0000,0,0
RILYO,0,100,25.5300,100,25.2700,0.0000,0,0
RINF,0,300,28.2600,300,28.0900,0.0000,0,0
RISN,0,3800,26.2600,200,26.2000,0.0000,0,0
RIVE,0,100,10.0500,100,9.9700,0.0000,0,0
RJZ,0,3,10.2800,100,10.1900,0.0000,0,0
RLJ-A,0,100,26.5500,100,25.9100,0.0000,0,0
RMI,0,100,21.5700,200,21.2500,0.0000,0,0
RMM,0,100,18.6300,100,18.4500,0.0000,0,0
RMPL-,0,100,25.5800,100,25.3000,0.0000,0,0
RNDV,0,300,25.9800,100,25.8700,0.0000,0,0
RNLC,0,1000,28.6500,1000,28.5000,0.0000,0,0
RNMC,0,1000,25.7900,600,25.5900,0.0000,0,0
RNR-E,0,100,25.4700,100,25.2600,0.0000,0,0
RNR-F,0,100,27.7000,100,27.3900,0.0000,0,0
RNSC,0,200,25.7100,400,25.6200,0.0000,0,0
ROAM,0,200,24.4100,400,24.2100,0.0000,0,0
ROCCU,0,100,11.3900,100,11.2100,0.0000,0,0
ROCCW,0,100,1.9100,100,1.7700,0.0000,0,0
ROOF,0,1000,22.2200,100,22.1300,0.0000,0,0
ROSC,0,100,34.3600,100,34.0800,0.0000,0,0
RPLA+,0,100,1.6700,100,1.5700,0.0000,0,0
RPLA=,0,100,11.2900,100,10.9600,0.0000,0,0
RPT-D,0,100,53.5500,100,53.1200,0.0000,0,0
RSF,0,100,17.1600,100,16.7300,0.0000,0,0
RTAI,0,3800,26.3000,200,26.2500,0.0000,0,0
RTH,0,200,163.2600,300,163.2100,0.0000,0,0
RVPH,0,100,8.9300,100,8.7200,0.0000,0,0
RVPHW,0,1000,0.6898,200,0.6600,0.0000,0,0
RWGV,0,100,107.6300,100,106.8100,0.0000,0,0
RWK,0,100,76.4200,1000,76.1000,0.0000,0,0
RXD,0,100,8.7200,180,8.6700,0.0000,0,0
RXI,0,500,164.5400,500,163.0800,0.0000,0,0
RY-T,0,100,29.8100,100,28.4900,0.0000,0,0
RYB,0,100,2.4800,100,2.4000,0.0000,0,0
RYJ,0,200,54.6900,1200,54.5800,0.0000,0,0
RZB,0,100,28.9600,100,28.3300,0.0000,0,0
SABRP,0,100,159.3500,12,159.0000,0.0000,0,0
SACC,0,100,25.0300,100,24.7900,0.0000,0,0
SAF,0,100,25.6900,100,25.3500,0.0000,0,0
SAIIU,0,400,11.9300,900,11.3900,0.0000,0,0
SAIIW,0,100,1.8300,125,1.7500,0.0000,0,0
SAK,0,100,26.4200,100,26.1300,0.0000,0,0
SBBA,0,100,25.1000,100,24.8500,0.0000,0,0
SBG,0,100,10.4500,100,10.2700,0.0000,0,0
SBG+,0,100,1.5200,100,1.4200,0.0000,0,0
SBLKZ,0,100,25.9000,100,25.4500,0.0000,0,0
SBM,0,100,11.9100,100,11.8000,0.0000,0,0
SBUG,0,400,36.0400,400,35.9800,0.0000,0,0
SCA,0,100,25.3300,100,25.1000,0.0000,0,0
SCC,0,70,11.3400,70,11.2500,0.0000,0,0
SCCB,0,100,25.5400,100,25.1800,0.0000,0,0
SCCC,0,100,25.2200,100,25.0000,0.0000,0,0
SCE-L,0,100,24.3700,300,24.1700,0.0000,0,0
SCPE+,0,100,1.8900,100,1.7800,0.0000,0,0
SCPE=,0,100,12.2000,100,11.1200,0.0000,0,0
SCVX=,0,100,11.6800,100,11.3400,0.0000,0,0
SDCI,0,100,16.7900,100,16.6600,0.0000,0,0
SDD,0,500,8.3300,180,8.3000,0.0000,0,0
SDEF,0,100,20.1700,100,19.8300,0.0000,0,0
SDEI,0,1000,21.1500,1000,20.9400,0.0000,0,0
SDGA,0,100,26.2000,100,25.9700,0.0000,0,0
SDHY,0,100,19.9600,900,19.6000,0.0000,0,0
SDVY,0,1000,25.4900,1000,25.4600,0.0000,0,0
SEF,0,400,15.6100,1200,15.6000,0.0000,0,0
SEIX,0,100,24.8900,100,24.7800,0.0000,0,0
SEPZ,0,1000,27.1800,1000,27.0800,0.0000,0,0
SF-B,0,100,27.1700,100,26.9600,0.0000,0,0
SF-C,0,100,27.9000,100,27.2900,0.0000,0,0
SFB,0,100,26.0200,100,25.7900,0.0000,0,0
SFIG,0,200,51.7600,4144,51.7300,0.0000,0,0
SFUN,0,100,13.2400,100,13.0000,0.0000,0,0
SG,0,100,12.3000,100,12.1600,0.0000,0,0
SGAMW,0,100,1.1600,200,1.0700,0.0000,0,0
SGG,0,100,48.4800,100,47.7100,0.0000,0,0
SGLBW,0,200,0.7300,2800,0.6500,0.0000,0,0
SGMA,0,100,5.2600,50,5.1500,0.0000,0,0
SGOV,0,100,100.0200,53000,100.0100,0.0000,0,0
SHIPZ,0,200,0.1792,200,0.0936,0.0000,0,0
SHO-F,0,100,24.3100,100,23.9100,0.0000,0,0
SITC-A,0,100,24.9600,100,24.6200,0.0000,0,0
SITC-K,0,100,24.7500,100,24.6200,0.0000,0,0
SIXA,0,100,30.9600,100,30.6500,0.0000,0,0
SIXH,0,1500,27.2200,1500,27.1500,0.0000,0,0
SIXL,0,100,31.6600,100,31.3300,0.0000,0,0
SIXS,0,100,41.2800,1600,41.0000,0.0000,0,0
SJ,0,100,9.4000,100,8.7400,0.0000,0,0
SLGL,0,100,10.3100,100,10.1900,0.0000,0,0
SLN,0,100,24.4900,100,22.9200,0.0000,0,0
SMCP,0,100,28.1800,100,27.9500,0.0000,0,0
SMDY,0,100,36.7100,100,36.3600,0.0000,0,0
SMEZ,0,100,73.8200,100,73.0900,0.0000,0,0
SMHB,0,100,9.3300,100,9.2300,0.0000,0,0
SMLV,0,200,101.3300,400,101.0900,0.0000,0,0
SMMU,0,200,51.5700,200,51.4500,0.0000,0,0
SNGXW,0,300,0.3731,300,0.1872,0.0000,0,0
SNLN,0,25000,16.2000,25500,16.1500,0.0000,0,0
SNPR+,0,100,3.2800,100,3.1800,0.0000,0,0
SNV-D,0,100,26.7000,100,26.2800,0.0000,0,0
SOJC,0,100,27.1800,100,26.8700,0.0000,0,0
SOR,0,100,41.6400,100,41.4000,0.0000,0,0
SOVB,0,100,26.2700,400,25.7500,0.0000,0,0
SPE-B,0,100,27.1200,100,26.8000,0.0000,0,0
SPG-J,0,100,70.7800,100,69.9900,0.0000,0,0
SPGM,0,100,51.4200,100,50.9100,0.0000,0,0
SPKEP,0,100,25.2900,100,24.9100,0.0000,0,0
SPMO,0,100,54.8900,100,54.3900,0.0000,0,0
SPMV,0,300,34.2700,100,34.1900,0.0000,0,0
SPNV+,0,100,2.4800,100,2.4000,0.0000,0,0
SPPP,0,100,17.7200,100,17.5400,0.0000,0,0
SPRE,0,100,20.4400,100,20.0500,0.0000,0,0
SPSK,0,100,20.4500,100,20.2600,0.0000,0,0
SPUC,0,2500,27.9100,2500,27.8500,0.0000,0,0
SPUS,0,100,26.1800,79,25.9200,0.0000,0,0
SPVM,0,600,42.7500,400,42.7200,0.0000,0,0
SPXE,0,500,83.9700,500,83.4700,0.0000,0,0
SPXN,0,500,82.5800,600,81.9700,0.0000,0,0
SPXV,0,500,80.8400,500,80.4900,0.0000,0,0
SQBG,0,100,16.0500,100,15.2000,0.0000,0,0
SQLV,0,700,32.4800,700,32.4600,0.0000,0,0
SRC-A,0,100,26.1400,100,25.7600,0.0000,0,0
SRG-A,0,100,17.1300,100,16.9400,0.0000,0,0
SRL,0,100,7.5800,200,7.4200,0.0000,0,0
SRRA,0,100,16.3100,100,15.8400,0.0000,0,0
SRSAU,0,100,11.0400,100,10.9100,0.0000,0,0
SRSAW,0,100,2.2000,200,2.1100,0.0000,0,0
SSG,0,69,11.3300,69,11.2500,0.0000,0,0
SSLY,0,100,47.4200,100,46.9900,0.0000,0,0
SSPY,0,100,58.2600,100,58.0000,0.0000,0,0
STAR-D,0,100,25.9900,100,25.7400,0.0000,0,0
STAR-G,0,100,25.4200,100,25.1600,0.0000,0,0
STAR-I,0,100,25.3600,100,24.9600,0.0000,0,0
STLG,0,900,32.9500,1100,32.9200,0.0000,0,0
STLV,0,2128,25.5800,1500,25.5500,0.0000,0,0
STRRP,0,100,10.9700,200,9.4100,0.0000,0,0
STT-D,0,100,28.9600,100,28.5200,0.0000,0,0
STT-G,0,100,28.5800,100,28.2000,0.0000,0,0
STZ.B,0,100,229.7700,100,227.4400,0.0000,0,0
SVT,0,100,8.8900,100,8.5100,0.0000,0,0
SVVC,0,100,5.1100,2,5.0500,0.0000,0,0
SWZ,0,100,9.1700,500,9.1200,0.0000,0,0
SYE,0,200,101.2600,500,101.1600,0.0000,0,0
SYTAW,0,100,5.3400,100,5.2200,0.0000,0,0
SYV,0,600,73.7400,500,73.1400,0.0000,0,0
SZK,0,100,8.4600,600,8.3800,0.0000,0,0
SZNE,0,700,33.1300,700,33.0900,0.0000,0,0
TAAG,0,100,27.6600,100,27.3800,0.0000,0,0
TADS,0,800,26.8500,900,26.7900,0.0000,0,0
TAEQ,0,100,26.6700,100,26.6000,0.0000,0,0
TAIT,0,100,3.2700,92,3.1600,0.0000,0,0
TALO+,0,100,0.0805,100,0.0560,0.0000,0,0
TANNI,0,100,26.3000,100,25.7600,0.0000,0,0
TANNL,0,100,25.6400,100,25.4400,0.0000,0,0
TANNZ,0,100,25.6400,100,25.2100,0.0000,0,0
TAP.A,0,100,71.3600,100,54.7800,0.0000,0,0
TAYD,0,100,10.5400,100,10.3700,0.0000,0,0
TBJL,0,300,24.1500,300,24.0600,0.0000,0,0
TBKCP,0,100,27.7100,100,27.0200,0.0000,0,0
TCBIL,0,100,25.5100,100,25.2700,0.0000,0,0
TCBIP,0,100,25.7000,50,25.4500,0.0000,0,0
TCFCP,0,100,26.3000,100,25.9800,0.0000,0,0
TCI,0,200,23.0000,100,22.3200,0.0000,0,0
TDACU,0,50,17.1400,100,15.4400,0.0000,0,0
TDACW,0,100,2.2600,100,2.1600,0.0000,0,0
TDE,0,100,25.5800,500,25.4500,0.0000,0,0
TDI,0,100,25.6400,100,25.3400,0.0000,0,0
TDJ,0,100,25.5800,100,25.3000,0.0000,0,0
TDSA,0,100,24.6500,800,24.4800,0.0000,0,0
TDSB,0,800,24.5400,100,24.4700,0.0000,0,0
TDSC,0,2000,25.0400,100,24.9800,0.0000,0,0
TDSD,0,2800,25.4200,2000,25.3500,0.0000,0,0
TDSE,0,2000,25.6300,2000,25.5700,0.0000,0,0
TDTF,0,100,27.9300,25100,27.9200,0.0000,0,0
TDW+A,0,200,1.1000,200,0.5904,0.0000,0,0
TDW+B,0,100,0.7700,100,0.6088,0.0000,0,0
TECTP,0,100,9.7800,100,9.5600,0.0000,0,0
TEGS,0,1500,27.1800,500,27.1000,0.0000,0,0
TEKKW,0,100,1.9300,100,1.8100,0.0000,0,0
TFC-I,0,100,26.4500,100,25.9400,0.0000,0,0
TFIV,0,500,23.9200,500,23.8500,0.0000,0,0
TFLT,0,500,24.3100,500,24.2500,0.0000,0,0
TGP-A,0,100,26.0700,100,25.8300,0.0000,0,0
TGRW,0,2000,29.9100,2000,29.8900,0.0000,0,0
THCAU,0,100,14.6900,100,13.2600,0.0000,0,0
THCBU,0,100,22.1000,100,19.9300,0.0000,0,0
THNQ,0,100,43.0200,100,42.5100,0.0000,0,0
THY,0,100,25.5200,5000,25.4300,0.0000,0,0
TIPX,0,22600,21.0100,23000,20.9900,0.0000,0,0
TLTE,0,100,62.4300,100,61.9100,0.0000,0,0
TMDV,0,700,42.4400,900,42.3900,0.0000,0,0
TMPMW,0,100,1.6700,100,1.4700,0.0000,0,0
TMTS,0,100,10.3400,100,10.2500,0.0000,0,0
TMTSU,0,100,10.8400,100,10.5400,0.0000,0,0
TMTSW,0,100,1.4400,100,1.3200,0.0000,0,0
TPAY,0,100,45.8100,100,45.3700,0.0000,0,0
TPLC,0,200,32.0500,200,31.8800,0.0000,0,0
TPSC,0,200,29.8000,300,29.6700,0.0000,0,0
TPVY,0,100,25.5900,100,25.2800,0.0000,0,0
TREB+,0,100,2.2300,100,2.1300,0.0000,0,0
TRMD,0,100,7.6200,100,7.4600,0.0000,0,0
TRMT,0,100,4.0900,200,3.9600,0.0000,0,0
TRTN-A,0,100,27.6100,100,27.2400,0.0000,0,0
TRTN-B,0,100,27.0400,100,26.8000,0.0000,0,0
TRTN-D,0,100,26.7000,100,26.1200,0.0000,0,0
TRTY,0,200,25.5300,19,25.5200,0.0000,0,0
TSCAP,0,100,28.0900,100,25.9600,0.0000,0,0
TSCBP,0,100,26.6000,100,25.9800,0.0000,0,0
TSIAW,0,200,2.4000,200,1.8600,0.0000,0,0
TSRI,0,100,7.3400,100,6.9200,0.0000,0,0
TTAI,0,250,33.0000,500,32.9900,0.0000,0,0
TTCFW,0,100,12.3400,100,12.2200,0.0000,0,0
TURN,0,100,6.7400,100,6.6300,0.0000,0,0
TUSA,0,600,43.6000,100,43.3800,0.0000,0,0
TVACU,0,100,10.6600,200,10.4800,0.0000,0,0
TWO-A,0,100,24.6400,100,24.3300,0.0000,0,0
TWO-D,0,100,24.6600,100,24.4400,0.0000,0,0
TY-,0,200,59.9000,200,54.1500,0.0000,0,0
TYD,0,14,57.2700,100,56.5300,0.0000,0,0
UAPR,0,400,25.1100,200,24.9600,0.0000,0,0
UBOH,0,100,25.1000,100,24.0900,0.0000,0,0
UBP,0,100,12.6200,100,12.2200,0.0000,0,0
UBP-H,0,100,24.7000,100,24.4300,0.0000,0,0
UBP-K,0,100,24.3600,100,24.1100,0.0000,0,0
UCL,0,100,10.3100,100,10.0700,0.0000,0,0
UFAB,0,100,7.3100,20,7.2400,0.0000,0,0
UFEB,0,3900,26.2600,4100,26.0800,0.0000,0,0
UG,0,100,14.2900,100,13.9600,0.0000,0,0
UGE,0,10,88.0200,10,87.2900,0.0000,0,0
UIVM,0,800,47.0700,800,46.8300,0.0000,0,0
UJB,0,100,75.1300,100,74.0400,0.0000,0,0
ULST,0,100,40.5000,100,40.4800,0.0000,0,0
ULTR,0,100,49.8600,100,49.4500,0.0000,0,0
UMH-C,0,100,25.3200,100,25.0900,0.0000,0,0
UPV,0,100,57.6300,100,56.8700,0.0000,0,0
USAI,0,100,19.9800,100,19.7300,0.0000,0,0
USHG,0,100,31.3900,100,31.1700,0.0000,0,0
USI,0,140,24.8700,100,24.8400,0.0000,0,0
USLB,0,1000,35.9200,1000,35.7700,0.0000,0,0
USTB,0,100,51.8800,100,51.8200,0.0000,0,0
UTES,0,1100,40.9400,1100,40.8200,0.0000,0,0
UZB,0,100,25.7000,100,25.4000,0.0000,0,0
UZC,0,100,25.6500,100,25.4400,0.0000,0,0
VACQU,0,100,10.9900,100,10.8600,0.0000,0,0
VBF,0,100,20.4600,100,20.2000,0.0000,0,0
VBFC,0,100,36.1400,100,33.6700,0.0000,0,0
VCF,0,100,14.1800,100,14.0200,0.0000,0,0
VCIF,0,100,10.0700,100,9.9600,0.0000,0,0
VEGA,0,100,37.5400,1000,37.1300,0.0000,0,0
VEGI,0,100,37.0000,100,36.8000,0.0000,0,0
VEL,0,100,7.4000,100,7.1700,0.0000,0,0
VETS,0,700,34.8800,700,34.8400,0.0000,0,0
VICE,0,200,32.3500,100,32.1000,0.0000,0,0
VINCU,0,100,27.0600,100,23.1100,0.0000,0,0
VIRC,0,100,2.8300,100,2.7200,0.0000,0,0
VKTXW,0,100,5.8300,100,5.2900,0.0000,0,0
VMACU,0,100,11.5400,100,11.2600,0.0000,0,0
VNMC,0,500,31.0200,500,30.9700,0.0000,0,0
VNO-L,0,100,25.1300,100,24.9200,0.0000,0,0
VNSE,0,500,28.3200,500,28.2900,0.0000,0,0
VRAI,0,400,23.6000,400,23.5400,0.0000,0,0
VST+A,0,100,0.5500,100,0.4400,0.0000,0,0
VTRN,0,1000,29.0500,1000,29.0400,0.0000,0,0
VTSI,0,100,4.0900,100,3.9500,0.0000,0,0
VYGG+,0,100,2.4000,100,2.2600,0.0000,0,0
WALA,0,100,25.8500,100,25.6000,0.0000,0,0
WBIE,0,100,29.1400,100,28.9500,0.0000,0,0
WBIF,0,100,28.3000,100,28.1200,0.0000,0,0
WBIG,0,100,24.1700,100,23.9900,0.0000,0,0
WBII,0,100,24.8800,100,24.7200,0.0000,0,0
WBIN,0,100,17.3100,100,17.2100,0.0000,0,0
WBIT,0,700,20.1600,500,20.1000,0.0000,0,0
WF,0,100,26.7200,200,26.4300,0.0000,0,0
WFC-P,0,100,25.6600,100,25.4200,0.0000,0,0
WHFBZ,0,100,26.0500,100,25.5800,0.0000,0,0
WHLM,0,100,4.8000,100,4.6600,0.0000,0,0
WHLR,0,200,2.8200,200,2.7000,0.0000,0,0
WHLRD,0,100,18.0700,100,17.5300,0.0000,0,0
WHLRP,0,100,14.0400,100,12.8000,0.0000,0,0
WIA,0,100,12.9700,200,12.8700,0.0000,0,0
WILC,0,100,21.5700,100,21.0100,0.0000,0,0
WINC,0,100,26.3400,100,26.2300,0.0000,0,0
WOMN,0,100,30.4100,100,30.0900,0.0000,0,0
WOOD,0,400,83.3000,400,82.8600,0.0000,0,0
WPG-H,0,100,17.3100,100,17.1700,0.0000,0,0
WPG-I,0,100,15.9700,100,15.7500,0.0000,0,0
WPS,0,300,35.5700,300,35.2500,0.0000,0,0
WRB-E,0,100,26.9300,100,26.5400,0.0000,0,0
WSG,0,50500,2.5000,25004,2.4900,0.0000,0,0
WSO.B,0,100,247.9400,100,245.3700,0.0000,0,0
WTREP,0,100,25.8300,100,25.4000,0.0000,0,0
WVFC,0,100,15.4600,100,14.7500,0.0000,0,0
WVVI,0,100,6.7700,100,6.6800,0.0000,0,0
WVVIP,0,200,5.9100,200,5.2800,0.0000,0,0
XBUY,0,400,54.9500,400,54.7300,0.0000,0,0
XDIV,0,100,86.2400,100,85.0600,0.0000,0,0
XHS,0,500,104.6000,500,104.3200,0.0000,0,0
XLSR,0,2000,41.1900,2000,41.1500,0.0000,0,0
XMVM,0,600,39.7600,500,39.3100,0.0000,0,0
XOMAP,0,100,25.3500,100,25.0200,0.0000,0,0
XPOA+,0,100,2.5400,100,2.4600,0.0000,0,0
XRLV,0,100,42.3500,200,42.2400,0.0000,0,0
XSMO,0,400,52.4600,500,52.3700,0.0000,0,0
XSVM,0,1000,39.4800,1000,39.1800,0.0000,0,0
XTL,0,400,93.0100,600,92.5900,0.0000,0,0
XWEB,0,100,169.7700,200,169.5800,0.0000,0,0
XYLG,0,400,28.1200,200,27.9700,0.0000,0,0
YAC=,0,1590,11.0000,100,10.7200,0.0000,0,0
YCL,0,500,59.5000,500,59.3800,0.0000,0,0
YCS,0,1000,68.2300,1000,68.1000,0.0000,0,0
YDEC,0,400,20.5900,69,20.5000,0.0000,0,0
YLD,0,100,40.2600,100,39.8000,0.0000,0,0
YLDE,0,2100,36.0700,1100,35.9100,0.0000,0,0
ZCAN,0,100,66.0900,100,65.8800,0.0000,0,0
ZDEU,0,100,65.3800,100,65.1900,0.0000,0,0
ZEAL,0,100,38.7500,100,37.2200,0.0000,0,0
ZGBR,0,200,48.2900,200,48.0600,0.0000,0,0
ZGYH,0,200,10.7100,200,9.6800,0.0000,0,0
ZGYHR,0,200,0.4992,200,0.2520,0.0000,0,0
ZGYHU,0,100,11.8400,100,10.6600,0.0000,0,0
ZGYHW,0,200,0.7600,200,0.6700,0.0000,0,0
ZHOK,0,100,71.5100,100,71.1400,0.0000,0,0
ZIG,0,900,24.5200,100,24.4500,0.0000,0,0
ZIONL,0,100,28.1400,100,27.3900,0.0000,0,0
ZIONN,0,100,25.9500,100,25.6500,0.0000,0,0
ZIONO,0,100,27.5600,100,27.0800,0.0000,0,0
ZIONP,0,100,24.9700,100,24.7100,0.0000,0,0
ZJPN,0,200,90.7900,100,90.2900,0.0000,0,0